행정기관코드,행정기관,구분,행정구역명,선거구코드,선거인수,투표수,더불어민주당 이재명,국민의힘 윤석열,정의당 심상정,기본소득당 오준호,국가혁명당  허경영,노동당 이백윤,새누리당 옥은호,신자유민주연합 김경재,우리공화당 조원진,진보당 김재연,통일한국당 이경희,한류연합당 김민찬,계,무효투표수,기권수
4100000000,경기도,도,,,11433288 ,8763727 ,4428151 ,3965341 ,205709 ,4151 ,63207 ,1919 ,1124 ,1990 ,5897 ,8768 ,1927 ,3192 ,8691376 ,72351 ,2669561 
4111000000,경기도 수원시 ,시군구,수원시,,1003834 ,777718 ,385312 ,356927 ,19897 ,437 ,5563 ,157 ,98 ,171 ,575 ,685 ,162 ,277 ,770261 ,7457 ,226116 
4111100000,경기도 수원시 장안구 ,행정구,수원시장안구,21011,234723 ,183882 ,91842 ,83470 ,4755 ,122 ,1320 ,27 ,27 ,38 ,170 ,188 ,46 ,68 ,182073 ,1809 ,50841 
4111156000,경기도 수원시 장안구 파장동,읍면동,파장동,2101,19438 ,14541 ,7257 ,6610 ,374 ,8 ,112 ,3 ,1 ,2 ,20 ,13 ,1 ,4 ,14405 ,136 ,4897 
4111156600,경기도 수원시 장안구 율천동,읍면동,율천동,2102,32061 ,25400 ,12734 ,11416 ,702 ,19 ,130 ,7 ,3 ,9 ,21 ,13 ,7 ,10 ,25071 ,329 ,6661 
4111157100,경기도 수원시 장안구 정자1동,읍면동,정자1동,2101,21770 ,16986 ,8594 ,7681 ,415 ,10 ,110 ,2 ,1 ,2 ,11 ,23 ,6 ,7 ,16862 ,124 ,4784 
4111157200,경기도 수원시 장안구 정자2동,읍면동,정자2동,2101,25440 ,18869 ,9329 ,8639 ,474 ,16 ,154 ,0 ,3 ,4 ,25 ,32 ,5 ,8 ,18689 ,180 ,6571 
4111157300,경기도 수원시 장안구 정자3동,읍면동,정자3동,2101,30237 ,24776 ,13461 ,10187 ,771 ,10 ,119 ,2 ,7 ,3 ,15 ,19 ,3 ,8 ,24605 ,171 ,5461 
4111158000,경기도 수원시 장안구 영화동,읍면동,영화동,2101,16587 ,11394 ,5377 ,5553 ,218 ,7 ,117 ,2 ,3 ,4 ,9 ,15 ,3 ,7 ,11315 ,79 ,5193 
4111159100,경기도 수원시 장안구 송죽동,읍면동,송죽동,2101,15320 ,11135 ,5645 ,5000 ,266 ,9 ,79 ,1 ,0 ,4 ,7 ,9 ,2 ,1 ,11023 ,112 ,4185 
4111159700,경기도 수원시 장안구 조원1동,읍면동,조원1동,2101,21846 ,15739 ,7759 ,7268 ,381 ,8 ,146 ,2 ,2 ,2 ,25 ,12 ,10 ,0 ,15615 ,124 ,6107 
4111159800,경기도 수원시 장안구 조원2동,읍면동,조원2동,2101,15062 ,12477 ,5765 ,6162 ,362 ,5 ,59 ,2 ,2 ,2 ,20 ,4 ,0 ,3 ,12386 ,91 ,2585 
4111160000,경기도 수원시 장안구 연무동,읍면동,연무동,2101,13248 ,9203 ,4080 ,4748 ,175 ,4 ,84 ,1 ,3 ,3 ,8 ,13 ,2 ,6 ,9127 ,76 ,4045 
4111300000,경기도 수원시 권선구 ,행정구,수원시권선구,21021,311536 ,235055 ,121028 ,103154 ,5754 ,121 ,1981 ,55 ,42 ,63 ,187 ,218 ,48 ,99 ,232750 ,2305 ,76481 
4111352000,경기도 수원시 권선구 세류1동,읍면동,세류1동,2105,8564 ,6657 ,3156 ,3187 ,177 ,3 ,48 ,2 ,3 ,4 ,8 ,8 ,0 ,1 ,6597 ,60 ,1907 
4111353000,경기도 수원시 권선구 세류2동,읍면동,세류2동,2105,19233 ,12248 ,6019 ,5626 ,279 ,9 ,151 ,2 ,3 ,7 ,16 ,14 ,2 ,4 ,12132 ,116 ,6985 
4111354000,경기도 수원시 권선구 세류3동,읍면동,세류3동,2105,15572 ,10405 ,5119 ,4820 ,218 ,11 ,110 ,0 ,1 ,0 ,12 ,9 ,1 ,4 ,10305 ,100 ,5167 
4111355000,경기도 수원시 권선구 평동,읍면동,평동,2102,31017 ,22629 ,11413 ,10149 ,563 ,10 ,221 ,5 ,2 ,4 ,20 ,15 ,3 ,8 ,22413 ,216 ,8388 
4111356000,경기도 수원시 권선구 서둔동,읍면동,서둔동,2102,28982 ,19526 ,10053 ,8520 ,473 ,10 ,217 ,8 ,3 ,5 ,22 ,20 ,9 ,7 ,19347 ,179 ,9456 
4111365000,경기도 수원시 권선구 구운동,읍면동,구운동,2102,19046 ,13965 ,7106 ,6232 ,295 ,6 ,134 ,4 ,8 ,5 ,16 ,12 ,2 ,5 ,13825 ,140 ,5081 
4111366200,경기도 수원시 권선구 금곡동,읍면동,금곡동,2102,34055 ,26533 ,14220 ,11230 ,641 ,14 ,137 ,4 ,1 ,6 ,23 ,30 ,0 ,12 ,26318 ,215 ,7522 
4111366400,경기도 수원시 권선구 호매실동,읍면동,호매실동,2102,32194 ,24158 ,13870 ,9306 ,615 ,13 ,123 ,4 ,4 ,6 ,11 ,15 ,7 ,8 ,23982 ,176 ,8036 
4111367000,경기도 수원시 권선구 권선1동,읍면동,권선1동,2105,19304 ,13229 ,6272 ,6306 ,313 ,7 ,131 ,4 ,0 ,5 ,7 ,9 ,5 ,6 ,13065 ,164 ,6075 
4111368000,경기도 수원시 권선구 권선2동,읍면동,권선2동,2105,34669 ,27486 ,13318 ,13002 ,699 ,12 ,151 ,5 ,4 ,6 ,22 ,16 ,4 ,10 ,27249 ,237 ,7183 
4111369000,경기도 수원시 권선구 곡선동,읍면동,곡선동,2105,25840 ,18023 ,9205 ,7967 ,460 ,8 ,160 ,1 ,3 ,5 ,11 ,16 ,6 ,7 ,17849 ,174 ,7817 
4111370000,경기도 수원시 권선구 입북동,읍면동,입북동,2102,12238 ,9740 ,5372 ,3978 ,204 ,3 ,81 ,2 ,1 ,3 ,9 ,8 ,2 ,7 ,9670 ,70 ,2498 
4111500000,경기도 수원시 팔달구 ,행정구,수원시팔달구,21031,161747 ,119627 ,58024 ,56051 ,3003 ,63 ,1046 ,30 ,14 ,24 ,97 ,128 ,28 ,39 ,118547 ,1080 ,42120 
4111565000,경기도 수원시 팔달구 매교동,읍면동,매교동,2103,5530 ,3852 ,1843 ,1826 ,89 ,2 ,44 ,2 ,1 ,2 ,6 ,5 ,1 ,3 ,3824 ,28 ,1678 
4111566000,경기도 수원시 팔달구 매산동,읍면동,매산동,2103,8433 ,5465 ,2421 ,2813 ,123 ,4 ,47 ,1 ,0 ,0 ,5 ,8 ,1 ,3 ,5426 ,39 ,2968 
4111567000,경기도 수원시 팔달구 고등동,읍면동,고등동,2103,15388 ,11280 ,5491 ,5257 ,306 ,5 ,102 ,1 ,3 ,1 ,8 ,12 ,5 ,4 ,11195 ,85 ,4108 
4111568000,경기도 수원시 팔달구 화서1동,읍면동,화서1동,2103,17656 ,12522 ,6273 ,5707 ,297 ,7 ,119 ,4 ,3 ,0 ,10 ,23 ,2 ,5 ,12450 ,72 ,5134 
4111569000,경기도 수원시 팔달구 화서2동,읍면동,화서2동,2103,19160 ,15356 ,7710 ,7001 ,419 ,7 ,88 ,3 ,2 ,2 ,13 ,7 ,3 ,1 ,15256 ,100 ,3804 
4111570000,경기도 수원시 팔달구 지동,읍면동,지동,2103,9253 ,6442 ,2977 ,3211 ,102 ,4 ,78 ,1 ,0 ,3 ,8 ,8 ,3 ,3 ,6398 ,44 ,2811 
4111571000,경기도 수원시 팔달구 우만1동,읍면동,우만1동,2103,16525 ,11380 ,5553 ,5278 ,254 ,11 ,120 ,3 ,1 ,2 ,14 ,10 ,5 ,2 ,11253 ,127 ,5145 
4111572000,경기도 수원시 팔달구 우만2동,읍면동,우만2동,2103,13403 ,10587 ,4834 ,5245 ,322 ,5 ,56 ,1 ,0 ,4 ,8 ,8 ,2 ,1 ,10486 ,101 ,2816 
4111573000,경기도 수원시 팔달구 인계동,읍면동,인계동,2103,29571 ,19171 ,9032 ,9223 ,477 ,5 ,167 ,2 ,0 ,5 ,10 ,12 ,4 ,7 ,18944 ,227 ,10400 
4111574000,경기도 수원시 팔달구 행궁동,읍면동,행궁동,2103,9207 ,6191 ,2787 ,3124 ,144 ,4 ,67 ,2 ,0 ,2 ,8 ,4 ,0 ,2 ,6144 ,47 ,3016 
4111700000,경기도 수원시 영통구 ,행정구,수원시영통구,21041,295828 ,239154 ,114418 ,114252 ,6385 ,131 ,1216 ,45 ,15 ,46 ,121 ,151 ,40 ,71 ,236891 ,2263 ,56674 
4111751000,경기도 수원시 영통구 매탄1동,읍면동,매탄1동,2104,13765 ,10601 ,4830 ,5306 ,284 ,4 ,58 ,1 ,1 ,2 ,7 ,9 ,1 ,4 ,10507 ,94 ,3164 
4111752000,경기도 수원시 영통구 매탄2동,읍면동,매탄2동,2104,11675 ,8718 ,4195 ,4136 ,222 ,5 ,62 ,1 ,2 ,2 ,6 ,11 ,2 ,3 ,8647 ,71 ,2957 
4111753000,경기도 수원시 영통구 매탄3동,읍면동,매탄3동,2104,26054 ,19770 ,9791 ,9039 ,550 ,20 ,114 ,8 ,2 ,4 ,8 ,16 ,2 ,11 ,19565 ,205 ,6284 
4111754000,경기도 수원시 영통구 매탄4동,읍면동,매탄4동,2104,16449 ,12053 ,5942 ,5538 ,327 ,8 ,92 ,2 ,0 ,2 ,15 ,15 ,3 ,3 ,11947 ,106 ,4396 
4111755000,경기도 수원시 영통구 원천동,읍면동,원천동,2104,27301 ,20666 ,9091 ,10724 ,511 ,9 ,107 ,6 ,1 ,4 ,22 ,12 ,6 ,6 ,20499 ,167 ,6635 
4111757000,경기도 수원시 영통구 영통1동,읍면동,영통1동,2104,24157 ,19408 ,9838 ,8755 ,528 ,7 ,93 ,5 ,1 ,4 ,4 ,8 ,3 ,5 ,19251 ,157 ,4749 
4111758000,경기도 수원시 영통구 영통2동,읍면동,영통2동,2105,21173 ,16757 ,8298 ,7740 ,425 ,4 ,71 ,2 ,0 ,1 ,11 ,4 ,6 ,2 ,16564 ,193 ,4416 
4111758500,경기도 수원시 영통구 영통3동,읍면동,영통3동,2105,24341 ,19371 ,9364 ,9126 ,534 ,11 ,92 ,3 ,2 ,4 ,11 ,11 ,2 ,0 ,19160 ,211 ,4970 
4111759300,경기도 수원시 영통구 망포1동,읍면동,망포1동,2105,19740 ,15367 ,7511 ,7225 ,417 ,7 ,68 ,2 ,1 ,3 ,4 ,8 ,0 ,5 ,15251 ,116 ,4373 
4111759600,경기도 수원시 영통구 망포2동,읍면동,망포2동,2105,20289 ,16889 ,8627 ,7633 ,430 ,8 ,63 ,1 ,1 ,0 ,5 ,9 ,2 ,3 ,16782 ,107 ,3400 
4111760000,경기도 수원시 영통구 광교1동,읍면동,광교1동,2104,37488 ,30656 ,13611 ,15795 ,879 ,11 ,81 ,3 ,0 ,9 ,4 ,16 ,7 ,3 ,30419 ,237 ,6832 
4111761000,경기도 수원시 영통구 광교2동,읍면동,광교2동,2104,20267 ,16346 ,7644 ,8076 ,404 ,6 ,71 ,3 ,4 ,5 ,13 ,13 ,1 ,5 ,16245 ,101 ,3921 
4113000000,경기도 성남시 ,시군구,성남시,,798769 ,638808 ,308047 ,307972 ,12932 ,227 ,2772 ,95 ,65 ,145 ,432 ,838 ,99 ,216 ,633840 ,4968 ,159961 
4113100000,경기도 성남시 수정구 ,행정구,성남시수정구,2106,207998 ,161006 ,86224 ,68806 ,3128 ,57 ,904 ,22 ,19 ,38 ,109 ,318 ,19 ,66 ,159710 ,1296 ,46992 
4113151000,경기도 성남시 수정구 신흥1동,읍면동,신흥1동,2106,11750 ,8098 ,4880 ,2923 ,154 ,2 ,47 ,0 ,2 ,2 ,5 ,21 ,1 ,4 ,8041 ,57 ,3652 
4113152000,경기도 성남시 수정구 신흥2동,읍면동,신흥2동,2106,13283 ,10455 ,4908 ,5154 ,238 ,3 ,49 ,1 ,1 ,3 ,7 ,12 ,1 ,0 ,10377 ,78 ,2828 
4113153000,경기도 성남시 수정구 신흥3동,읍면동,신흥3동,2106,10226 ,7184 ,4047 ,2902 ,113 ,3 ,44 ,1 ,0 ,0 ,7 ,15 ,1 ,3 ,7136 ,48 ,3042 
4113154000,경기도 성남시 수정구 태평1동,읍면동,태평1동,2106,13383 ,9884 ,5663 ,3853 ,195 ,3 ,47 ,2 ,0 ,2 ,4 ,20 ,2 ,4 ,9795 ,89 ,3499 
4113155000,경기도 성남시 수정구 태평2동,읍면동,태평2동,2106,11674 ,8086 ,4720 ,3052 ,144 ,2 ,62 ,0 ,0 ,2 ,11 ,21 ,1 ,6 ,8021 ,65 ,3588 
4113156000,경기도 성남시 수정구 태평3동,읍면동,태평3동,2106,11464 ,8430 ,4894 ,3227 ,140 ,2 ,62 ,2 ,0 ,1 ,8 ,25 ,4 ,3 ,8368 ,62 ,3034 
4113156100,경기도 성남시 수정구 태평4동,읍면동,태평4동,2106,9872 ,6826 ,3973 ,2550 ,133 ,2 ,66 ,0 ,2 ,1 ,2 ,18 ,2 ,3 ,6752 ,74 ,3046 
4113157000,경기도 성남시 수정구 수진1동,읍면동,수진1동,2106,10446 ,7073 ,4155 ,2635 ,126 ,5 ,46 ,1 ,2 ,3 ,6 ,13 ,4 ,2 ,6998 ,75 ,3373 
4113158000,경기도 성남시 수정구 수진2동,읍면동,수진2동,2106,12380 ,9234 ,5155 ,3784 ,144 ,3 ,52 ,1 ,1 ,4 ,5 ,24 ,0 ,2 ,9175 ,59 ,3146 
4113159000,경기도 성남시 수정구 단대동,읍면동,단대동,2106,11161 ,8386 ,4565 ,3512 ,162 ,3 ,44 ,4 ,1 ,1 ,14 ,9 ,0 ,4 ,8319 ,67 ,2775 
4113160000,경기도 성남시 수정구 산성동,읍면동,산성동,2106,5010 ,3885 ,2314 ,1421 ,85 ,2 ,22 ,0 ,0 ,1 ,1 ,11 ,0 ,3 ,3860 ,25 ,1125 
4113161000,경기도 성남시 수정구 양지동,읍면동,양지동,2106,8936 ,6929 ,4086 ,2586 ,126 ,7 ,52 ,1 ,1 ,0 ,5 ,21 ,0 ,2 ,6887 ,42 ,2007 
4113162000,경기도 성남시 수정구 복정동,읍면동,복정동,2106,8975 ,6750 ,3673 ,2801 ,173 ,1 ,35 ,2 ,1 ,2 ,6 ,3 ,0 ,4 ,6701 ,49 ,2225 
4113162500,경기도 성남시 수정구 위례동,읍면동,위례동,2106,31932 ,25361 ,11648 ,12944 ,493 ,6 ,68 ,3 ,4 ,5 ,16 ,22 ,1 ,12 ,25222 ,139 ,6571 
4113163000,경기도 성남시 수정구 신촌동,읍면동,신촌동,2106,3253 ,2481 ,1111 ,1274 ,48 ,0 ,17 ,0 ,2 ,1 ,0 ,2 ,0 ,0 ,2455 ,26 ,772 
4113164000,경기도 성남시 수정구 고등동,읍면동,고등동,2106,7795 ,6392 ,3026 ,3130 ,126 ,2 ,36 ,0 ,0 ,2 ,2 ,11 ,2 ,2 ,6339 ,53 ,1403 
4113165000,경기도 성남시 수정구 시흥동,읍면동,시흥동,2106,2500 ,1927 ,757 ,1113 ,33 ,0 ,8 ,0 ,0 ,0 ,2 ,5 ,0 ,1 ,1919 ,8 ,573 
4113300000,경기도 성남시 중원구 ,행정구,성남시중원구,21071,186278 ,142368 ,80857 ,56072 ,2799 ,65 ,861 ,28 ,15 ,25 ,94 ,322 ,38 ,69 ,141245 ,1123 ,43910 
4113351000,경기도 성남시 중원구 성남동,읍면동,성남동,2107,26681 ,18868 ,10502 ,7653 ,364 ,6 ,98 ,4 ,2 ,2 ,16 ,36 ,4 ,11 ,18698 ,170 ,7813 
4113352500,경기도 성남시 중원구 중앙동,읍면동,중앙동,2107,9613 ,7057 ,3919 ,2905 ,115 ,3 ,34 ,0 ,3 ,1 ,8 ,15 ,3 ,5 ,7011 ,46 ,2556 
4113353000,경기도 성남시 중원구 금광1동,읍면동,금광1동,2107,5743 ,4145 ,2383 ,1611 ,81 ,5 ,23 ,0 ,2 ,0 ,1 ,12 ,2 ,2 ,4122 ,23 ,1598 
4113354000,경기도 성남시 중원구 금광2동,읍면동,금광2동,2107,19042 ,13592 ,7505 ,5583 ,278 ,7 ,70 ,1 ,1 ,1 ,7 ,39 ,3 ,5 ,13500 ,92 ,5450 
4113355000,경기도 성남시 중원구 은행1동,읍면동,은행1동,2107,8141 ,6158 ,3643 ,2228 ,145 ,6 ,44 ,4 ,1 ,2 ,7 ,18 ,0 ,2 ,6100 ,58 ,1983 
4113356000,경기도 성남시 중원구 은행2동,읍면동,은행2동,2107,18476 ,13566 ,7863 ,5175 ,258 ,2 ,97 ,6 ,3 ,5 ,11 ,29 ,4 ,9 ,13462 ,104 ,4910 
4113357000,경기도 성남시 중원구 상대원1동,읍면동,상대원1동,2107,19208 ,13600 ,7951 ,5134 ,253 ,8 ,97 ,1 ,0 ,1 ,6 ,22 ,4 ,7 ,13484 ,116 ,5608 
4113358000,경기도 성남시 중원구 상대원2동,읍면동,상대원2동,2107,11013 ,7634 ,4443 ,2897 ,123 ,7 ,51 ,0 ,0 ,4 ,9 ,25 ,3 ,3 ,7565 ,69 ,3379 
4113359000,경기도 성남시 중원구 상대원3동,읍면동,상대원3동,2107,10788 ,7635 ,4566 ,2810 ,113 ,3 ,59 ,0 ,0 ,3 ,8 ,18 ,4 ,4 ,7588 ,47 ,3153 
4113366000,경기도 성남시 중원구 하대원동,읍면동,하대원동,2107,16303 ,12863 ,7098 ,5320 ,249 ,5 ,59 ,1 ,1 ,1 ,5 ,25 ,1 ,7 ,12772 ,91 ,3440 
4113367000,경기도 성남시 중원구 도촌동,읍면동,도촌동,2107,18921 ,15138 ,8270 ,6356 ,318 ,3 ,70 ,4 ,0 ,2 ,7 ,17 ,2 ,5 ,15054 ,84 ,3783 
4113500000,경기도 성남시 분당구 ,행정구,성남시분당구,21081,404493 ,335434 ,140966 ,183094 ,7005 ,105 ,1007 ,45 ,31 ,82 ,229 ,198 ,42 ,81 ,332885 ,2549 ,69059 
4113551000,경기도 성남시 분당구 분당동,읍면동,분당동,2109,17687 ,13868 ,5835 ,7568 ,311 ,5 ,47 ,4 ,0 ,4 ,3 ,9 ,1 ,5 ,13792 ,76 ,3819 
4113552000,경기도 성남시 분당구 수내1동,읍면동,수내1동,2109,14092 ,11481 ,4335 ,6792 ,212 ,4 ,26 ,0 ,1 ,4 ,5 ,1 ,0 ,2 ,11382 ,99 ,2611 
4113553000,경기도 성남시 분당구 수내2동,읍면동,수내2동,2109,7559 ,6477 ,2387 ,3918 ,125 ,0 ,12 ,1 ,0 ,1 ,1 ,2 ,0 ,2 ,6449 ,28 ,1082 
4113554000,경기도 성남시 분당구 수내3동,읍면동,수내3동,2109,10055 ,8151 ,3610 ,4272 ,176 ,0 ,28 ,3 ,0 ,1 ,8 ,6 ,0 ,2 ,8106 ,45 ,1904 
4113554500,경기도 성남시 분당구 정자동,읍면동,정자동,2109,13735 ,10911 ,4350 ,6128 ,265 ,7 ,41 ,0 ,0 ,5 ,8 ,6 ,2 ,1 ,10813 ,98 ,2824 
4113555000,경기도 성남시 분당구 정자1동,읍면동,정자1동,2109,22755 ,17654 ,5452 ,11739 ,283 ,5 ,37 ,0 ,3 ,1 ,10 ,5 ,1 ,5 ,17541 ,113 ,5101 
4113556000,경기도 성남시 분당구 정자2동,읍면동,정자2동,2109,13668 ,11143 ,5091 ,5641 ,246 ,5 ,47 ,3 ,1 ,1 ,10 ,7 ,3 ,7 ,11062 ,81 ,2525 
4113557000,경기도 성남시 분당구 정자3동,읍면동,정자3동,2109,12242 ,10062 ,4387 ,5324 ,243 ,6 ,24 ,0 ,0 ,3 ,8 ,7 ,0 ,3 ,10005 ,57 ,2180 
4113558000,경기도 성남시 분당구 서현1동,읍면동,서현1동,2108,24321 ,19651 ,7672 ,11370 ,394 ,5 ,59 ,4 ,3 ,3 ,8 ,11 ,2 ,3 ,19534 ,117 ,4670 
4113559000,경기도 성남시 분당구 서현2동,읍면동,서현2동,2108,14990 ,12515 ,5530 ,6577 ,242 ,5 ,34 ,2 ,1 ,2 ,12 ,12 ,5 ,2 ,12424 ,91 ,2475 
4113560000,경기도 성남시 분당구 이매1동,읍면동,이매1동,2108,18456 ,15356 ,5912 ,9008 ,277 ,0 ,38 ,4 ,1 ,2 ,11 ,7 ,3 ,6 ,15269 ,87 ,3100 
4113561000,경기도 성남시 분당구 이매2동,읍면동,이매2동,2108,10172 ,8607 ,3141 ,5250 ,131 ,0 ,21 ,1 ,2 ,2 ,7 ,2 ,2 ,0 ,8559 ,48 ,1565 
4113562000,경기도 성남시 분당구 야탑1동,읍면동,야탑1동,2108,14990 ,12442 ,5592 ,6460 ,225 ,5 ,40 ,3 ,2 ,2 ,18 ,7 ,0 ,2 ,12356 ,86 ,2548 
4113563000,경기도 성남시 분당구 야탑2동,읍면동,야탑2동,2108,12778 ,10751 ,4050 ,6385 ,204 ,2 ,28 ,0 ,1 ,7 ,8 ,2 ,1 ,2 ,10690 ,61 ,2027 
4113564000,경기도 성남시 분당구 야탑3동,읍면동,야탑3동,2108,20502 ,16025 ,7946 ,7466 ,371 ,7 ,62 ,1 ,2 ,3 ,17 ,23 ,3 ,6 ,15907 ,118 ,4477 
4113565000,경기도 성남시 분당구 판교동,읍면동,판교동,2108,18313 ,15412 ,6540 ,8391 ,357 ,3 ,25 ,1 ,0 ,4 ,6 ,4 ,4 ,5 ,15340 ,72 ,2901 
4113565500,경기도 성남시 분당구 삼평동,읍면동,삼평동,2108,17619 ,14498 ,6668 ,7300 ,356 ,11 ,41 ,2 ,2 ,3 ,12 ,14 ,1 ,1 ,14411 ,87 ,3121 
4113565700,경기도 성남시 분당구 백현동,읍면동,백현동,2108,19978 ,16375 ,7491 ,8336 ,355 ,3 ,54 ,2 ,2 ,3 ,5 ,6 ,2 ,1 ,16260 ,115 ,3603 
4113566200,경기도 성남시 분당구 금곡동,읍면동,금곡동,2109,20700 ,16433 ,6603 ,9242 ,356 ,2 ,56 ,2 ,1 ,10 ,16 ,11 ,2 ,2 ,16303 ,130 ,4267 
4113566500,경기도 성남시 분당구 구미1동,읍면동,구미1동,2109,15600 ,13117 ,5861 ,6810 ,286 ,2 ,34 ,1 ,1 ,4 ,8 ,5 ,3 ,3 ,13018 ,99 ,2483 
4113567000,경기도 성남시 분당구 구미동,읍면동,구미동,2109,22432 ,17853 ,7366 ,9881 ,372 ,5 ,57 ,1 ,2 ,7 ,22 ,14 ,0 ,6 ,17733 ,120 ,4579 
4113568000,경기도 성남시 분당구 운중동,읍면동,운중동,2108,22559 ,18776 ,7936 ,10273 ,386 ,3 ,38 ,2 ,3 ,3 ,9 ,10 ,1 ,0 ,18664 ,112 ,3783 
4115000000,경기도 의정부시 ,시군구,의정부시,,398960 ,295029 ,154851 ,127348 ,6788 ,152 ,2338 ,51 ,33 ,65 ,226 ,592 ,72 ,112 ,292628 ,2401 ,103931 
4115051000,경기도 의정부시 의정부1동,읍면동,의정부1동,2110,26776 ,15905 ,7925 ,7251 ,349 ,9 ,162 ,4 ,2 ,3 ,19 ,32 ,9 ,4 ,15769 ,136 ,10871 
4115052000,경기도 의정부시 의정부2동,읍면동,의정부2동,2110,26491 ,17797 ,9376 ,7588 ,445 ,14 ,147 ,1 ,1 ,3 ,28 ,31 ,4 ,4 ,17642 ,155 ,8694 
4115054500,경기도 의정부시 호원1동,읍면동,호원1동,2110,28904 ,21852 ,11237 ,9727 ,506 ,6 ,136 ,7 ,3 ,8 ,11 ,25 ,8 ,9 ,21683 ,169 ,7052 
4115055500,경기도 의정부시 호원2동,읍면동,호원2동,2110,28198 ,21591 ,11121 ,9697 ,440 ,6 ,124 ,2 ,4 ,0 ,23 ,26 ,4 ,6 ,21453 ,138 ,6607 
4115056100,경기도 의정부시 장암동,읍면동,장암동,2111,15985 ,12398 ,6409 ,5494 ,276 ,3 ,81 ,3 ,0 ,3 ,6 ,14 ,5 ,1 ,12295 ,103 ,3587 
4115056700,경기도 의정부시 신곡1동,읍면동,신곡1동,2111,33293 ,24584 ,12887 ,10686 ,549 ,13 ,197 ,3 ,2 ,1 ,27 ,35 ,4 ,9 ,24413 ,171 ,8709 
4115056800,경기도 의정부시 신곡2동,읍면동,신곡2동,2111,36884 ,27914 ,14258 ,12527 ,682 ,16 ,167 ,2 ,3 ,5 ,16 ,25 ,2 ,12 ,27715 ,199 ,8970 
4115057300,경기도 의정부시 송산1동,읍면동,송산1동,2111,34168 ,24097 ,12731 ,10311 ,581 ,7 ,182 ,0 ,4 ,8 ,22 ,51 ,6 ,11 ,23914 ,183 ,10071 
4115057600,경기도 의정부시 송산2동,읍면동,송산2동,2111,26171 ,19454 ,10709 ,7935 ,456 ,14 ,120 ,7 ,3 ,8 ,10 ,45 ,6 ,5 ,19318 ,136 ,6717 
4115057800,경기도 의정부시 송산3동,읍면동,송산3동,2111,33257 ,24349 ,13658 ,9763 ,558 ,4 ,150 ,4 ,2 ,8 ,7 ,37 ,1 ,9 ,24201 ,148 ,8908 
4115058000,경기도 의정부시 자금동,읍면동,자금동,2111,21579 ,15370 ,7946 ,6754 ,346 ,11 ,154 ,3 ,0 ,0 ,8 ,16 ,4 ,4 ,15246 ,124 ,6209 
4115059500,경기도 의정부시 가능동,읍면동,가능동,2110,20902 ,13848 ,7114 ,6163 ,285 ,7 ,124 ,1 ,2 ,3 ,8 ,21 ,5 ,5 ,13738 ,110 ,7054 
4115061500,경기도 의정부시 흥선동,읍면동,흥선동,2110,15988 ,10744 ,5619 ,4601 ,255 ,2 ,112 ,1 ,2 ,7 ,17 ,15 ,3 ,4 ,10638 ,106 ,5244 
4115062000,경기도 의정부시 녹양동,읍면동,녹양동,2110,17160 ,12445 ,6396 ,5519 ,298 ,8 ,114 ,3 ,2 ,2 ,13 ,13 ,3 ,3 ,12374 ,71 ,4715 
4117000000,경기도 안양시 ,시군구,안양시,,471978 ,379441 ,187871 ,175699 ,9475 ,144 ,2126 ,86 ,42 ,82 ,289 ,249 ,86 ,135 ,376284 ,3157 ,92537 
4117100000,경기도 안양시 만안구 ,행정구,안양시만안구,21121,209083 ,162812 ,82650 ,73147 ,3901 ,72 ,1111 ,39 ,17 ,40 ,145 ,134 ,46 ,68 ,161370 ,1442 ,46271 
4117151000,경기도 안양시 만안구 안양1동,읍면동,안양1동,2112,9861 ,7778 ,3756 ,3629 ,223 ,3 ,52 ,2 ,1 ,1 ,9 ,7 ,0 ,2 ,7685 ,93 ,2083 
4117152000,경기도 안양시 만안구 안양2동,읍면동,안양2동,2112,16950 ,12221 ,6173 ,5511 ,281 ,4 ,102 ,1 ,1 ,4 ,21 ,9 ,3 ,4 ,12114 ,107 ,4729 
4117153000,경기도 안양시 만안구 안양3동,읍면동,안양3동,2112,13840 ,10198 ,5221 ,4535 ,253 ,3 ,67 ,0 ,0 ,7 ,5 ,6 ,4 ,2 ,10103 ,95 ,3642 
4117154000,경기도 안양시 만안구 안양4동,읍면동,안양4동,2112,6468 ,5002 ,2444 ,2351 ,111 ,3 ,35 ,1 ,0 ,1 ,3 ,2 ,2 ,2 ,4955 ,47 ,1466 
4117155000,경기도 안양시 만안구 안양5동,읍면동,안양5동,2112,8677 ,6324 ,3054 ,3014 ,129 ,3 ,56 ,3 ,2 ,1 ,6 ,8 ,2 ,2 ,6280 ,44 ,2353 
4117156000,경기도 안양시 만안구 안양6동,읍면동,안양6동,2112,20060 ,14311 ,7207 ,6501 ,354 ,6 ,99 ,2 ,3 ,1 ,13 ,6 ,4 ,3 ,14199 ,112 ,5749 
4117157000,경기도 안양시 만안구 안양7동,읍면동,안양7동,2112,11856 ,9542 ,4778 ,4419 ,209 ,2 ,43 ,2 ,0 ,1 ,9 ,4 ,1 ,2 ,9470 ,72 ,2314 
4117158000,경기도 안양시 만안구 안양8동,읍면동,안양8동,2112,9229 ,6730 ,3386 ,3064 ,150 ,4 ,54 ,3 ,0 ,4 ,5 ,6 ,3 ,2 ,6681 ,49 ,2499 
4117158100,경기도 안양시 만안구 안양9동,읍면동,안양9동,2112,13327 ,9918 ,4845 ,4674 ,218 ,6 ,57 ,3 ,5 ,1 ,10 ,10 ,4 ,6 ,9839 ,79 ,3409 
4117159000,경기도 안양시 만안구 석수1동,읍면동,석수1동,2112,15317 ,12442 ,6063 ,5924 ,289 ,7 ,52 ,3 ,1 ,3 ,13 ,3 ,3 ,3 ,12364 ,78 ,2875 
4117160000,경기도 안양시 만안구 석수2동,읍면동,석수2동,2112,24833 ,19439 ,9962 ,8638 ,494 ,7 ,127 ,3 ,1 ,5 ,19 ,17 ,4 ,7 ,19284 ,155 ,5394 
4117161000,경기도 안양시 만안구 석수3동,읍면동,석수3동,2112,10467 ,7890 ,4203 ,3341 ,181 ,3 ,56 ,2 ,1 ,1 ,8 ,8 ,3 ,7 ,7814 ,76 ,2577 
4117162100,경기도 안양시 만안구 박달1동,읍면동,박달1동,2112,12619 ,9272 ,4896 ,4005 ,180 ,3 ,57 ,1 ,0 ,2 ,13 ,12 ,5 ,6 ,9180 ,92 ,3347 
4117163000,경기도 안양시 만안구 박달2동,읍면동,박달2동,2112,16550 ,13030 ,6675 ,5811 ,311 ,5 ,89 ,3 ,0 ,4 ,6 ,9 ,4 ,8 ,12925 ,105 ,3520 
4117300000,경기도 안양시 동안구 ,행정구,안양시동안구,,262895 ,216629 ,105221 ,102552 ,5574 ,72 ,1015 ,47 ,25 ,42 ,144 ,115 ,40 ,67 ,214914 ,1715 ,46266 
4117351000,경기도 안양시 동안구 비산1동,읍면동,비산1동,2113,17373 ,14270 ,6807 ,6927 ,342 ,0 ,56 ,3 ,3 ,2 ,9 ,4 ,1 ,7 ,14161 ,109 ,3103 
4117352000,경기도 안양시 동안구 비산2동,읍면동,비산2동,2113,11477 ,9683 ,4778 ,4555 ,238 ,5 ,34 ,2 ,0 ,0 ,8 ,4 ,1 ,3 ,9628 ,55 ,1794 
4117353000,경기도 안양시 동안구 비산3동,읍면동,비산3동,2113,10205 ,7659 ,3793 ,3574 ,151 ,1 ,60 ,3 ,0 ,1 ,6 ,7 ,1 ,7 ,7604 ,55 ,2546 
4117354000,경기도 안양시 동안구 부흥동,읍면동,부흥동,2113,13348 ,11167 ,5547 ,5149 ,308 ,4 ,43 ,1 ,1 ,2 ,11 ,6 ,3 ,3 ,11078 ,89 ,2181 
4117354600,경기도 안양시 동안구 달안동,읍면동,달안동,2113,9513 ,7618 ,3710 ,3555 ,222 ,3 ,43 ,1 ,2 ,2 ,8 ,6 ,1 ,4 ,7557 ,61 ,1895 
4117355000,경기도 안양시 동안구 관양1동,읍면동,관양1동,2113,27373 ,20661 ,10060 ,9788 ,474 ,7 ,116 ,6 ,4 ,0 ,25 ,12 ,4 ,8 ,20504 ,157 ,6712 
4117356000,경기도 안양시 동안구 관양2동,읍면동,관양2동,2113,15026 ,11589 ,5599 ,5490 ,315 ,6 ,67 ,2 ,1 ,3 ,9 ,7 ,7 ,3 ,11509 ,80 ,3437 
4117356600,경기도 안양시 동안구 부림동,읍면동,부림동,2113,19625 ,15490 ,7924 ,6937 ,417 ,3 ,61 ,2 ,1 ,4 ,6 ,6 ,1 ,2 ,15364 ,126 ,4135 
4117357000,경기도 안양시 동안구 평촌동,읍면동,평촌동,2114,11131 ,9386 ,4550 ,4451 ,272 ,3 ,38 ,2 ,1 ,2 ,5 ,6 ,1 ,0 ,9331 ,55 ,1745 
4117357600,경기도 안양시 동안구 평안동,읍면동,평안동,2114,16474 ,13847 ,7032 ,6266 ,396 ,2 ,43 ,2 ,1 ,2 ,4 ,7 ,3 ,1 ,13759 ,88 ,2627 
4117357800,경기도 안양시 동안구 귀인동,읍면동,귀인동,2114,11241 ,9483 ,4382 ,4776 ,215 ,5 ,28 ,1 ,2 ,0 ,4 ,1 ,2 ,7 ,9423 ,60 ,1758 
4117358000,경기도 안양시 동안구 호계1동,읍면동,호계1동,2114,13413 ,11213 ,5386 ,5397 ,298 ,2 ,43 ,3 ,1 ,2 ,3 ,5 ,0 ,1 ,11141 ,72 ,2200 
4117359000,경기도 안양시 동안구 호계2동,읍면동,호계2동,2114,14079 ,11136 ,5330 ,5332 ,290 ,5 ,53 ,2 ,3 ,6 ,8 ,11 ,1 ,4 ,11045 ,91 ,2943 
4117360000,경기도 안양시 동안구 호계3동,읍면동,호계3동,2114,17356 ,13798 ,6803 ,6460 ,329 ,3 ,70 ,3 ,2 ,3 ,11 ,3 ,2 ,2 ,13691 ,107 ,3558 
4117361000,경기도 안양시 동안구 범계동,읍면동,범계동,2114,12562 ,10611 ,4675 ,5493 ,329 ,3 ,29 ,2 ,0 ,2 ,3 ,6 ,3 ,2 ,10547 ,64 ,1951 
4117362000,경기도 안양시 동안구 신촌동,읍면동,신촌동,2114,10232 ,8631 ,4119 ,4176 ,218 ,4 ,38 ,2 ,1 ,1 ,6 ,0 ,2 ,3 ,8570 ,61 ,1601 
4117363000,경기도 안양시 동안구 갈산동,읍면동,갈산동,2114,8147 ,6604 ,2899 ,3459 ,148 ,2 ,33 ,4 ,0 ,5 ,4 ,5 ,1 ,4 ,6564 ,40 ,1543 
4119000000,경기도 부천시 ,시군구,부천시,,699678 ,532995 ,285227 ,224331 ,13249 ,351 ,3817 ,126 ,76 ,125 ,323 ,515 ,118 ,218 ,528476 ,4519 ,166683 
4119060300,경기도 부천시 심곡동,읍면동,심곡동,2115,53909 ,36781 ,19823 ,15241 ,884 ,26 ,347 ,10 ,9 ,14 ,29 ,38 ,8 ,14 ,36443 ,338 ,17128 
4119060600,경기도 부천시 부천동,읍면동,부천동,2115,74822 ,55352 ,30924 ,21978 ,1386 ,46 ,434 ,18 ,3 ,12 ,33 ,63 ,9 ,24 ,54930 ,422 ,19470 
4119061000,경기도 부천시 중동,읍면동,중동,2116,33254 ,25113 ,12549 ,11513 ,626 ,19 ,152 ,5 ,4 ,5 ,23 ,18 ,5 ,10 ,24929 ,184 ,8141 
4119074200,경기도 부천시 신중동,읍면동,신중동,2116,102278 ,78631 ,39756 ,35771 ,1928 ,48 ,390 ,14 ,14 ,17 ,37 ,55 ,17 ,21 ,78068 ,563 ,23647 
4119074400,경기도 부천시 상동,읍면동,상동,2116,65597 ,52781 ,27545 ,23141 ,1413 ,18 ,215 ,12 ,4 ,13 ,26 ,19 ,5 ,13 ,52424 ,357 ,12816 
4119074600,경기도 부천시 대산동,읍면동,대산동,2117,65980 ,48304 ,25192 ,20968 ,1244 ,25 ,337 ,18 ,4 ,12 ,34 ,39 ,8 ,13 ,47894 ,410 ,17676 
4119075000,경기도 부천시 소사본동,읍면동,소사본동,2117,44275 ,32882 ,17035 ,14489 ,766 ,23 ,221 ,5 ,7 ,6 ,37 ,30 ,8 ,14 ,32641 ,241 ,11393 
4119079500,경기도 부천시 범안동,읍면동,범안동,2117,70059 ,53963 ,29679 ,22048 ,1386 ,30 ,317 ,10 ,3 ,12 ,27 ,49 ,14 ,16 ,53591 ,372 ,16096 
4119080000,경기도 부천시 성곡동,읍면동,성곡동,2118,67534 ,48086 ,27158 ,18895 ,1057 ,38 ,419 ,11 ,5 ,9 ,25 ,47 ,13 ,30 ,47707 ,379 ,19448 
4119083000,경기도 부천시 오정동,읍면동,오정동,2118,67068 ,47076 ,26030 ,18924 ,1125 ,32 ,399 ,8 ,8 ,12 ,38 ,56 ,14 ,29 ,46675 ,401 ,19992 
4121000000,경기도 광명시 ,시군구,광명시,,247357 ,198669 ,103470 ,87112 ,4746 ,98 ,1118 ,46 ,24 ,30 ,151 ,138 ,50 ,75 ,197058 ,1611 ,48688 
4121051000,경기도 광명시 광명1동,읍면동,광명1동,2119,#N/A,#N/A,#N/A,#N/A,#N/A,#N/A,#N/A,#N/A,#N/A,#N/A,#N/A,#N/A,#N/A,#N/A,#N/A,#N/A,#N/A
4121052000,경기도 광명시 광명2동,읍면동,광명2동,2119,3507 ,2531 ,1312 ,1125 ,48 ,1 ,20 ,2 ,1 ,1 ,1 ,1 ,1 ,0 ,2513 ,18 ,976 
4121054000,경기도 광명시 광명3동,읍면동,광명3동,2119,8339 ,6000 ,3096 ,2689 ,113 ,4 ,47 ,1 ,1 ,1 ,8 ,3 ,1 ,5 ,5969 ,31 ,2339 
4121055000,경기도 광명시 광명4동,읍면동,광명4동,2119,11222 ,8509 ,4280 ,3875 ,193 ,6 ,67 ,1 ,2 ,2 ,11 ,4 ,1 ,3 ,8445 ,64 ,2713 
4121056000,경기도 광명시 광명5동,읍면동,광명5동,2119,10163 ,7562 ,3884 ,3396 ,153 ,3 ,45 ,1 ,0 ,0 ,10 ,6 ,1 ,5 ,7504 ,58 ,2601 
4121057000,경기도 광명시 광명6동,읍면동,광명6동,2119,8422 ,6645 ,3358 ,3049 ,136 ,3 ,39 ,2 ,2 ,2 ,10 ,4 ,1 ,1 ,6607 ,38 ,1777 
4121058000,경기도 광명시 광명7동,읍면동,광명7동,2119,16160 ,12236 ,6338 ,5426 ,264 ,7 ,76 ,4 ,1 ,0 ,10 ,10 ,3 ,1 ,12140 ,96 ,3924 
4121059000,경기도 광명시 철산1동,읍면동,철산1동,2119,8239 ,6773 ,3659 ,2840 ,166 ,11 ,31 ,2 ,1 ,1 ,4 ,5 ,2 ,0 ,6722 ,51 ,1466 
4121060000,경기도 광명시 철산2동,읍면동,철산2동,2119,4852 ,3442 ,1775 ,1520 ,78 ,4 ,31 ,1 ,0 ,1 ,3 ,3 ,1 ,2 ,3419 ,23 ,1410 
4121061000,경기도 광명시 철산3동,읍면동,철산3동,2119,25082 ,20782 ,10002 ,9944 ,533 ,11 ,89 ,7 ,0 ,4 ,20 ,5 ,3 ,7 ,20625 ,157 ,4300 
4121062000,경기도 광명시 철산4동,읍면동,철산4동,2119,11043 ,8899 ,4965 ,3540 ,238 ,4 ,51 ,2 ,0 ,1 ,10 ,6 ,2 ,6 ,8825 ,74 ,2144 
4121063100,경기도 광명시 하안1동,읍면동,하안1동,2120,18878 ,15150 ,7765 ,6827 ,361 ,1 ,70 ,3 ,1 ,2 ,8 ,7 ,2 ,2 ,15049 ,101 ,3728 
4121063200,경기도 광명시 하안2동,읍면동,하안2동,2120,11211 ,8765 ,4669 ,3728 ,235 ,2 ,40 ,3 ,3 ,1 ,5 ,5 ,3 ,2 ,8696 ,69 ,2446 
4121063300,경기도 광명시 하안3동,읍면동,하안3동,2120,16124 ,12684 ,6738 ,5472 ,267 ,4 ,58 ,4 ,1 ,3 ,10 ,9 ,4 ,4 ,12574 ,110 ,3440 
4121063400,경기도 광명시 하안4동,읍면동,하안4동,2120,10414 ,8584 ,4695 ,3509 ,248 ,3 ,44 ,1 ,1 ,3 ,5 ,4 ,2 ,2 ,8517 ,67 ,1830 
4121064000,경기도 광명시 소하1동,읍면동,소하1동,2120,23130 ,18485 ,10237 ,7541 ,432 ,7 ,82 ,6 ,0 ,6 ,7 ,14 ,8 ,7 ,18347 ,138 ,4645 
4121065000,경기도 광명시 소하2동,읍면동,소하2동,2120,22370 ,17222 ,9353 ,7136 ,429 ,4 ,112 ,1 ,2 ,1 ,13 ,21 ,6 ,10 ,17088 ,134 ,5148 
4121065500,경기도 광명시 일직동,읍면동,일직동,2120,15021 ,12012 ,5784 ,5775 ,324 ,5 ,38 ,1 ,1 ,0 ,5 ,7 ,2 ,1 ,11943 ,69 ,3009 
4121066000,경기도 광명시 학온동,읍면동,학온동,2120,2109 ,1702 ,663 ,990 ,25 ,1 ,11 ,1 ,0 ,0 ,3 ,0 ,2 ,2 ,1698 ,4 ,407 
4122000000,경기도 평택시 ,시군구,평택시,,472732 ,338768 ,166032 ,156630 ,7988 ,166 ,3791 ,108 ,47 ,71 ,220 ,525 ,87 ,140 ,335805 ,2963 ,133964 
4122025000,경기도 평택시 팽성읍,읍면동,팽성읍,2122,23756 ,15437 ,6656 ,8150 ,253 ,9 ,195 ,4 ,0 ,4 ,12 ,18 ,5 ,8 ,15314 ,123 ,8319 
4122025300,경기도 평택시 안중읍,읍면동,안중읍,2122,31733 ,21949 ,11791 ,9095 ,571 ,10 ,252 ,5 ,1 ,5 ,22 ,49 ,5 ,6 ,21812 ,137 ,9784 
4122025600,경기도 평택시 포승읍,읍면동,포승읍,2122,19057 ,12413 ,6391 ,5441 ,251 ,3 ,178 ,6 ,3 ,1 ,7 ,29 ,3 ,11 ,12324 ,89 ,6644 
4122025900,경기도 평택시 청북읍,읍면동,청북읍,2122,18636 ,12947 ,7212 ,5212 ,274 ,5 ,140 ,4 ,1 ,1 ,10 ,19 ,4 ,6 ,12888 ,59 ,5689 
4122031000,경기도 평택시 진위면,읍면동,진위면,2121,9426 ,6369 ,2984 ,3081 ,151 ,5 ,79 ,2 ,2 ,1 ,4 ,13 ,3 ,6 ,6331 ,38 ,3057 
4122032000,경기도 평택시 서탄면,읍면동,서탄면,2121,3151 ,2297 ,909 ,1282 ,45 ,0 ,36 ,1 ,2 ,0 ,2 ,3 ,1 ,2 ,2283 ,14 ,854 
4122033000,경기도 평택시 고덕면,읍면동,고덕면,2122,10523 ,7195 ,3280 ,3574 ,169 ,1 ,85 ,1 ,2 ,1 ,8 ,26 ,1 ,1 ,7149 ,46 ,3328 
4122034000,경기도 평택시 오성면,읍면동,오성면,2122,6132 ,4461 ,1892 ,2362 ,105 ,1 ,51 ,2 ,0 ,1 ,8 ,6 ,3 ,1 ,4432 ,29 ,1671 
4122037000,경기도 평택시 현덕면,읍면동,현덕면,2122,5580 ,4365 ,1928 ,2276 ,75 ,3 ,38 ,1 ,0 ,1 ,4 ,7 ,4 ,3 ,4340 ,25 ,1215 
4122051000,경기도 평택시 중앙동,읍면동,중앙동,2121,34708 ,24041 ,11607 ,11209 ,597 ,15 ,274 ,9 ,2 ,8 ,13 ,47 ,6 ,11 ,23798 ,243 ,10667 
4122052000,경기도 평택시 서정동,읍면동,서정동,2121,21144 ,13368 ,6503 ,6205 ,260 ,6 ,187 ,4 ,1 ,3 ,17 ,16 ,3 ,10 ,13215 ,153 ,7776 
4122053500,경기도 평택시 송탄동,읍면동,송탄동,2121,16434 ,11661 ,6051 ,5083 ,287 ,3 ,125 ,1 ,2 ,1 ,6 ,11 ,5 ,7 ,11582 ,79 ,4773 
4122055000,경기도 평택시 지산동,읍면동,지산동,2121,11490 ,7211 ,3568 ,3271 ,151 ,3 ,114 ,4 ,1 ,2 ,2 ,9 ,1 ,2 ,7128 ,83 ,4279 
4122056000,경기도 평택시 송북동,읍면동,송북동,2121,17922 ,12368 ,5813 ,5977 ,309 ,7 ,139 ,2 ,0 ,2 ,6 ,12 ,1 ,7 ,12275 ,93 ,5554 
4122057000,경기도 평택시 신장1동,읍면동,신장1동,2121,5858 ,3716 ,1723 ,1777 ,95 ,5 ,58 ,3 ,0 ,2 ,3 ,3 ,0 ,1 ,3670 ,46 ,2142 
4122058000,경기도 평택시 신장2동,읍면동,신장2동,2121,5430 ,3235 ,1395 ,1684 ,64 ,1 ,50 ,0 ,0 ,1 ,3 ,10 ,2 ,0 ,3210 ,25 ,2195 
4122059000,경기도 평택시 신평동,읍면동,신평동,2122,18456 ,11849 ,5187 ,6123 ,259 ,2 ,131 ,10 ,2 ,5 ,8 ,19 ,6 ,6 ,11758 ,91 ,6607 
4122060000,경기도 평택시 원평동,읍면동,원평동,2122,11659 ,8294 ,3827 ,4040 ,222 ,8 ,96 ,1 ,3 ,2 ,5 ,10 ,2 ,4 ,8220 ,74 ,3365 
4122061000,경기도 평택시 통복동,읍면동,통복동,2121,5211 ,4022 ,1803 ,2029 ,89 ,2 ,41 ,1 ,1 ,3 ,1 ,6 ,1 ,1 ,3978 ,44 ,1189 
4122062000,경기도 평택시 비전1동,읍면동,비전1동,2121,36548 ,26469 ,13770 ,11525 ,672 ,12 ,234 ,6 ,3 ,2 ,13 ,46 ,2 ,4 ,26289 ,180 ,10079 
4122063000,경기도 평택시 비전2동,읍면동,비전2동,2122,40673 ,29554 ,14212 ,14040 ,747 ,15 ,215 ,6 ,4 ,2 ,26 ,47 ,6 ,12 ,29332 ,222 ,11119 
4122063500,경기도 평택시 용이동,읍면동,용이동,2122,19405 ,14473 ,7838 ,6054 ,336 ,6 ,128 ,3 ,1 ,2 ,8 ,16 ,0 ,3 ,14395 ,78 ,4932 
4122064000,경기도 평택시 세교동,읍면동,세교동,2121,22197 ,15678 ,7680 ,7318 ,346 ,3 ,144 ,5 ,2 ,4 ,7 ,34 ,6 ,4 ,15553 ,125 ,6519 
4122065000,경기도 평택시 동삭동,읍면동,동삭동,2121,26057 ,18655 ,9774 ,8064 ,463 ,5 ,154 ,2 ,2 ,5 ,11 ,20 ,5 ,7 ,18512 ,143 ,7402 
4122066000,경기도 평택시 고덕동,읍면동,고덕동,2122,15326 ,11036 ,5408 ,5090 ,296 ,8 ,129 ,5 ,1 ,1 ,5 ,9 ,0 ,2 ,10954 ,82 ,4290 
4125000000,경기도 동두천시 ,시군구,동두천시,21231,81075 ,57532 ,28495 ,26434 ,1125 ,26 ,647 ,14 ,11 ,22 ,61 ,141 ,24 ,32 ,57032 ,500 ,23543 
4125051000,경기도 동두천시 생연1동,읍면동,생연1동,2123,5784 ,3830 ,1839 ,1842 ,57 ,1 ,55 ,1 ,0 ,0 ,1 ,7 ,4 ,2 ,3809 ,21 ,1954 
4125052000,경기도 동두천시 생연2동,읍면동,생연2동,2123,9425 ,6635 ,3312 ,3025 ,128 ,3 ,77 ,3 ,2 ,5 ,7 ,13 ,2 ,5 ,6582 ,53 ,2790 
4125053500,경기도 동두천시 중앙동,읍면동,중앙동,2123,4793 ,3229 ,1452 ,1666 ,40 ,1 ,40 ,0 ,2 ,2 ,1 ,6 ,1 ,2 ,3213 ,16 ,1564 
4125055000,경기도 동두천시 보산동,읍면동,보산동,2123,2683 ,1814 ,826 ,905 ,33 ,1 ,25 ,0 ,0 ,2 ,5 ,2 ,2 ,0 ,1801 ,13 ,869 
4125056500,경기도 동두천시 불현동,읍면동,불현동,2123,19837 ,13098 ,6505 ,6025 ,251 ,4 ,137 ,5 ,1 ,1 ,16 ,24 ,6 ,8 ,12983 ,115 ,6739 
4125056600,경기도 동두천시 송내동,읍면동,송내동,2123,20407 ,14618 ,7694 ,6353 ,300 ,6 ,115 ,2 ,1 ,6 ,11 ,20 ,3 ,6 ,14517 ,101 ,5789 
4125058000,경기도 동두천시 소요동,읍면동,소요동,2123,7514 ,5174 ,2367 ,2576 ,101 ,3 ,44 ,3 ,1 ,3 ,11 ,12 ,3 ,2 ,5126 ,48 ,2340 
4125060000,경기도 동두천시 상패동,읍면동,상패동,2123,4722 ,3346 ,1564 ,1611 ,72 ,1 ,51 ,0 ,2 ,0 ,8 ,3 ,2 ,1 ,3315 ,31 ,1376 
4127000000,경기도 안산시 ,시군구,안산시,,564072 ,415202 ,225083 ,171259 ,9666 ,299 ,3807 ,115 ,61 ,83 ,288 ,420 ,99 ,190 ,411370 ,3832 ,148870 
4127100000,경기도 안산시 상록구 ,행정구,안산시상록구,,303413 ,222254 ,121488 ,90654 ,5103 ,165 ,2092 ,60 ,32 ,48 ,152 ,237 ,58 ,106 ,220195 ,2059 ,81159 
4127151000,경기도 안산시 상록구 일동,읍면동,일동,2125,20022 ,13515 ,8000 ,4933 ,269 ,16 ,124 ,7 ,1 ,5 ,5 ,25 ,3 ,7 ,13395 ,120 ,6507 
4127151500,경기도 안산시 상록구 이동,읍면동,이동,2125,19182 ,12350 ,6692 ,5072 ,277 ,12 ,144 ,3 ,3 ,3 ,11 ,13 ,6 ,4 ,12240 ,110 ,6832 
4127152500,경기도 안산시 상록구 사동,읍면동,사동,2124,28825 ,20172 ,11389 ,7832 ,475 ,11 ,205 ,8 ,1 ,1 ,10 ,29 ,3 ,8 ,19972 ,200 ,8653 
4127153200,경기도 안산시 상록구 사이동,읍면동,사이동,2124,24994 ,17803 ,9877 ,7128 ,379 ,14 ,194 ,4 ,3 ,2 ,12 ,20 ,9 ,6 ,17648 ,155 ,7191 
4127153700,경기도 안산시 상록구 해양동,읍면동,해양동,2124,27258 ,21482 ,10684 ,9977 ,538 ,13 ,93 ,2 ,1 ,2 ,9 ,9 ,0 ,2 ,21330 ,152 ,5776 
4127154000,경기도 안산시 상록구 본오1동,읍면동,본오1동,2124,28883 ,18606 ,10931 ,6815 ,400 ,10 ,193 ,4 ,4 ,5 ,9 ,20 ,5 ,12 ,18408 ,198 ,10277 
4127155000,경기도 안산시 상록구 본오2동,읍면동,본오2동,2124,21077 ,15047 ,8392 ,5967 ,353 ,10 ,141 ,0 ,3 ,4 ,13 ,18 ,5 ,10 ,14916 ,131 ,6030 
4127156000,경기도 안산시 상록구 본오3동,읍면동,본오3동,2124,17387 ,12874 ,6943 ,5370 ,288 ,13 ,113 ,4 ,1 ,1 ,15 ,13 ,5 ,7 ,12773 ,101 ,4513 
4127157000,경기도 안산시 상록구 부곡동,읍면동,부곡동,2125,17557 ,12038 ,6889 ,4621 ,265 ,8 ,117 ,4 ,4 ,1 ,12 ,12 ,0 ,8 ,11941 ,97 ,5519 
4127158000,경기도 안산시 상록구 월피동,읍면동,월피동,2125,29764 ,20209 ,11397 ,7894 ,450 ,20 ,210 ,6 ,0 ,7 ,16 ,22 ,9 ,11 ,20042 ,167 ,9555 
4127159000,경기도 안산시 상록구 성포동,읍면동,성포동,2125,21088 ,16644 ,8435 ,7534 ,408 ,6 ,71 ,2 ,5 ,4 ,15 ,18 ,2 ,9 ,16509 ,135 ,4444 
4127160000,경기도 안산시 상록구 반월동,읍면동,반월동,2124,14352 ,10980 ,5505 ,4998 ,259 ,8 ,96 ,6 ,4 ,2 ,12 ,7 ,2 ,3 ,10902 ,78 ,3372 
4127161000,경기도 안산시 상록구 안산동,읍면동,안산동,2125,7508 ,5361 ,2822 ,2340 ,94 ,2 ,55 ,2 ,1 ,2 ,6 ,0 ,1 ,5 ,5330 ,31 ,2147 
4127300000,경기도 안산시 단원구 ,행정구,안산시단원구,,260659 ,192948 ,103595 ,80605 ,4563 ,134 ,1715 ,55 ,29 ,35 ,136 ,183 ,41 ,84 ,191175 ,1773 ,67711 
4127351000,경기도 안산시 단원구 와동,읍면동,와동,2126,30273 ,19042 ,11198 ,6875 ,420 ,20 ,277 ,7 ,1 ,4 ,18 ,28 ,4 ,14 ,18866 ,176 ,11231 
4127352500,경기도 안산시 단원구 고잔동,읍면동,고잔동,2127,18316 ,13018 ,7055 ,5330 ,358 ,12 ,127 ,6 ,0 ,0 ,7 ,11 ,6 ,5 ,12917 ,101 ,5298 
4127353200,경기도 안산시 단원구 중앙동,읍면동,중앙동,2127,19740 ,14351 ,7331 ,6375 ,354 ,10 ,107 ,2 ,3 ,3 ,13 ,8 ,6 ,5 ,14217 ,134 ,5389 
4127353500,경기도 안산시 단원구 호수동,읍면동,호수동,2127,33030 ,26218 ,13560 ,11596 ,641 ,13 ,131 ,5 ,7 ,1 ,10 ,19 ,3 ,9 ,25995 ,223 ,6812 
4127354500,경기도 안산시 단원구 원곡동,읍면동,원곡동,2126,5185 ,2970 ,1686 ,1190 ,36 ,0 ,28 ,1 ,0 ,1 ,6 ,3 ,0 ,0 ,2951 ,19 ,2215 
4127355500,경기도 안산시 단원구 백운동,읍면동,백운동,2126,17764 ,13509 ,7086 ,5832 ,328 ,9 ,103 ,1 ,1 ,1 ,13 ,17 ,1 ,2 ,13394 ,115 ,4255 
4127356500,경기도 안산시 단원구 신길동,읍면동,신길동,2126,17408 ,12504 ,6980 ,4987 ,273 ,5 ,103 ,4 ,3 ,4 ,16 ,16 ,5 ,7 ,12403 ,101 ,4904 
4127357000,경기도 안산시 단원구 초지동,읍면동,초지동,2127,35301 ,26073 ,14133 ,10797 ,659 ,17 ,176 ,4 ,1 ,6 ,11 ,15 ,5 ,11 ,25835 ,238 ,9228 
4127358000,경기도 안산시 단원구 선부1동,읍면동,선부1동,2126,15235 ,11549 ,6114 ,4931 ,262 ,11 ,100 ,3 ,2 ,3 ,7 ,14 ,1 ,4 ,11452 ,97 ,3686 
4127359000,경기도 안산시 단원구 선부2동,읍면동,선부2동,2126,13337 ,8831 ,5012 ,3401 ,191 ,4 ,104 ,4 ,5 ,1 ,6 ,6 ,3 ,3 ,8740 ,91 ,4506 
4127360000,경기도 안산시 단원구 선부3동,읍면동,선부3동,2126,26613 ,18680 ,10423 ,7407 ,452 ,9 ,173 ,8 ,4 ,5 ,10 ,21 ,1 ,5 ,18518 ,162 ,7933 
4127361000,경기도 안산시 단원구 대부동,읍면동,대부동,2127,7226 ,5240 ,1938 ,3140 ,62 ,2 ,48 ,4 ,2 ,2 ,5 ,0 ,2 ,2 ,5207 ,33 ,1986 
4128000000,경기도 고양시 ,시군구,고양시,,922067 ,717348 ,363624 ,321440 ,20650 ,363 ,4071 ,183 ,76 ,186 ,458 ,620 ,105 ,193 ,711969 ,5379 ,204719 
4128100000,경기도 고양시 덕양구 ,행정구,고양시덕양구,21281,414210 ,323033 ,167037 ,139914 ,10643 ,165 ,1932 ,89 ,46 ,86 ,208 ,340 ,48 ,81 ,320589 ,2444 ,91177 
4128151000,경기도 고양시 덕양구 주교동,읍면동,주교동,2128,12141 ,8361 ,4368 ,3547 ,282 ,4 ,69 ,3 ,2 ,1 ,8 ,10 ,0 ,4 ,8298 ,63 ,3780 
4128152000,경기도 고양시 덕양구 원신동,읍면동,원신동,2128,15963 ,12123 ,6316 ,5185 ,463 ,4 ,62 ,0 ,1 ,8 ,3 ,5 ,0 ,0 ,12047 ,76 ,3840 
4128153000,경기도 고양시 덕양구 흥도동,읍면동,흥도동,2128,20025 ,15605 ,8357 ,6339 ,708 ,6 ,80 ,1 ,3 ,4 ,9 ,8 ,2 ,0 ,15517 ,88 ,4420 
4128154000,경기도 고양시 덕양구 성사1동,읍면동,성사1동,2128,17973 ,13230 ,6742 ,5856 ,424 ,5 ,75 ,2 ,1 ,8 ,16 ,14 ,3 ,1 ,13147 ,83 ,4743 
4128155000,경기도 고양시 덕양구 성사2동,읍면동,성사2동,2128,9208 ,7152 ,3638 ,3172 ,240 ,3 ,49 ,1 ,0 ,1 ,5 ,6 ,0 ,1 ,7116 ,36 ,2056 
4128156000,경기도 고양시 덕양구 효자동,읍면동,효자동,2129,10989 ,8808 ,4455 ,3877 ,329 ,5 ,42 ,2 ,2 ,5 ,6 ,14 ,0 ,1 ,8738 ,70 ,2181 
4128157600,경기도 고양시 덕양구 삼송1동,읍면동,삼송1동,2129,16277 ,13239 ,6540 ,6086 ,448 ,4 ,56 ,6 ,4 ,3 ,4 ,8 ,1 ,3 ,13163 ,76 ,3038 
4128157700,경기도 고양시 덕양구 삼송2동,읍면동,삼송2동,2129,19716 ,14870 ,7533 ,6612 ,503 ,6 ,78 ,6 ,0 ,4 ,10 ,11 ,2 ,5 ,14770 ,100 ,4846 
4128158000,경기도 고양시 덕양구 창릉동,읍면동,창릉동,2129,17660 ,13957 ,7117 ,6238 ,424 ,2 ,73 ,3 ,2 ,2 ,8 ,5 ,0 ,2 ,13876 ,81 ,3703 
4128159000,경기도 고양시 덕양구 고양동,읍면동,고양동,2128,22873 ,16189 ,8391 ,6965 ,568 ,8 ,101 ,2 ,5 ,6 ,9 ,12 ,6 ,7 ,16080 ,109 ,6684 
4128160000,경기도 고양시 덕양구 관산동,읍면동,관산동,2128,28856 ,19216 ,9910 ,8270 ,665 ,5 ,183 ,4 ,4 ,4 ,14 ,18 ,6 ,13 ,19096 ,120 ,9640 
4128161000,경기도 고양시 덕양구 능곡동,읍면동,능곡동,2129,12477 ,9438 ,4470 ,4564 ,262 ,4 ,58 ,4 ,2 ,1 ,7 ,11 ,1 ,1 ,9385 ,53 ,3039 
4128162100,경기도 고양시 덕양구 화정1동,읍면동,화정1동,2128,31877 ,24765 ,12010 ,11562 ,843 ,17 ,112 ,4 ,5 ,6 ,17 ,22 ,2 ,3 ,24603 ,162 ,7112 
4128162200,경기도 고양시 덕양구 화정2동,읍면동,화정2동,2128,24146 ,18899 ,9853 ,8171 ,633 ,7 ,67 ,4 ,1 ,1 ,6 ,14 ,3 ,5 ,18765 ,134 ,5247 
4128163000,경기도 고양시 덕양구 행주동,읍면동,행주동,2129,14694 ,10016 ,4989 ,4528 ,257 ,2 ,108 ,5 ,0 ,5 ,9 ,26 ,2 ,1 ,9932 ,84 ,4678 
4128164000,경기도 고양시 덕양구 행신1동,읍면동,행신1동,2129,16784 ,13111 ,6782 ,5724 ,401 ,11 ,62 ,4 ,3 ,3 ,5 ,16 ,5 ,2 ,13018 ,93 ,3673 
4128165000,경기도 고양시 덕양구 행신2동,읍면동,행신2동,2129,24985 ,19728 ,10155 ,8610 ,625 ,9 ,92 ,7 ,1 ,5 ,16 ,30 ,5 ,7 ,19562 ,166 ,5257 
4128165500,경기도 고양시 덕양구 행신3동,읍면동,행신3동,2129,19240 ,15622 ,8360 ,6554 ,486 ,5 ,62 ,6 ,3 ,2 ,15 ,16 ,1 ,4 ,15514 ,108 ,3618 
4128165600,경기도 고양시 덕양구 행신4동,읍면동,행신4동,2129,16172 ,11914 ,6571 ,4763 ,344 ,8 ,92 ,2 ,1 ,3 ,6 ,16 ,0 ,4 ,11810 ,104 ,4258 
4128166000,경기도 고양시 덕양구 화전동,읍면동,화전동,2129,18699 ,14536 ,7900 ,6005 ,402 ,11 ,90 ,5 ,4 ,8 ,11 ,18 ,2 ,1 ,14457 ,79 ,4163 
4128167000,경기도 고양시 덕양구 대덕동,읍면동,대덕동,2129,1999 ,1495 ,707 ,738 ,30 ,1 ,10 ,0 ,0 ,0 ,3 ,1 ,0 ,0 ,1490 ,5 ,504 
4128500000,경기도 고양시 일산동구 ,행정구,고양시일산동구,21301,256654 ,197004 ,96990 ,91849 ,5032 ,90 ,1120 ,51 ,12 ,53 ,120 ,133 ,24 ,49 ,195523 ,1481 ,59650 
4128551000,경기도 고양시 일산동구 식사동,읍면동,식사동,2130,26840 ,20703 ,9494 ,10503 ,473 ,3 ,90 ,1 ,1 ,4 ,9 ,6 ,1 ,3 ,20588 ,115 ,6137 
4128552500,경기도 고양시 일산동구 중산1동,읍면동,중산1동,2130,17589 ,12964 ,6256 ,6129 ,365 ,8 ,77 ,6 ,0 ,4 ,12 ,11 ,1 ,2 ,12871 ,93 ,4625 
4128552600,경기도 고양시 일산동구 중산2동,읍면동,중산2동,2130,18009 ,13405 ,7153 ,5731 ,329 ,8 ,71 ,1 ,0 ,4 ,6 ,11 ,3 ,4 ,13321 ,84 ,4604 
4128553000,경기도 고양시 일산동구 정발산동,읍면동,정발산동,2130,18430 ,13662 ,6682 ,6389 ,366 ,8 ,76 ,8 ,1 ,6 ,8 ,8 ,1 ,5 ,13558 ,104 ,4768 
4128554000,경기도 고양시 일산동구 풍산동,읍면동,풍산동,2130,27656 ,20441 ,10780 ,8821 ,527 ,11 ,97 ,6 ,3 ,6 ,10 ,16 ,2 ,6 ,20285 ,156 ,7215 
4128555100,경기도 고양시 일산동구 백석1동,읍면동,백석1동,2129,23191 ,17935 ,8960 ,8243 ,490 ,9 ,79 ,1 ,1 ,5 ,8 ,9 ,3 ,4 ,17812 ,123 ,5256 
4128555200,경기도 고양시 일산동구 백석2동,읍면동,백석2동,2129,17520 ,12542 ,6530 ,5481 ,336 ,7 ,81 ,1 ,1 ,4 ,11 ,5 ,2 ,1 ,12460 ,82 ,4978 
4128556000,경기도 고양시 일산동구 마두1동,읍면동,마두1동,2130,18505 ,14793 ,6997 ,7160 ,437 ,7 ,68 ,1 ,0 ,2 ,10 ,3 ,3 ,3 ,14691 ,102 ,3712 
4128557000,경기도 고양시 일산동구 마두2동,읍면동,마두2동,2130,14198 ,11844 ,5530 ,5953 ,251 ,5 ,26 ,3 ,0 ,2 ,8 ,6 ,0 ,2 ,11786 ,58 ,2354 
4128558000,경기도 고양시 일산동구 장항1동,읍면동,장항1동,2130,7896 ,6095 ,2529 ,3381 ,116 ,0 ,29 ,0 ,0 ,2 ,3 ,5 ,0 ,0 ,6065 ,30 ,1801 
4128559000,경기도 고양시 일산동구 장항2동,읍면동,장항2동,2130,21076 ,13771 ,6464 ,6790 ,307 ,3 ,82 ,4 ,1 ,5 ,12 ,8 ,3 ,6 ,13685 ,86 ,7305 
4128560000,경기도 고양시 일산동구 고봉동,읍면동,고봉동,2130,17065 ,10762 ,5207 ,5074 ,266 ,6 ,108 ,5 ,1 ,4 ,10 ,8 ,2 ,0 ,10691 ,71 ,6303 
4128700000,경기도 고양시 일산서구 ,행정구,고양시일산서구,21311,251203 ,197311 ,99597 ,89677 ,4975 ,108 ,1019 ,43 ,18 ,47 ,130 ,147 ,33 ,63 ,195857 ,1454 ,53892 
4128751000,경기도 고양시 일산서구 일산1동,읍면동,일산1동,2131,20786 ,15571 ,8056 ,6871 ,404 ,12 ,92 ,1 ,2 ,3 ,8 ,21 ,6 ,5 ,15481 ,90 ,5215 
4128752000,경기도 고양시 일산서구 일산2동,읍면동,일산2동,2130,14878 ,11070 ,5509 ,5149 ,246 ,5 ,66 ,0 ,1 ,6 ,11 ,15 ,1 ,4 ,11013 ,57 ,3808 
4128753000,경기도 고양시 일산서구 일산3동,읍면동,일산3동,2131,24963 ,20077 ,10338 ,8973 ,530 ,11 ,64 ,2 ,2 ,5 ,10 ,9 ,2 ,5 ,19951 ,126 ,4886 
4128754500,경기도 고양시 일산서구 탄현1동,읍면동,탄현1동,2131,24641 ,18551 ,9811 ,7964 ,496 ,11 ,101 ,4 ,2 ,4 ,11 ,14 ,3 ,9 ,18430 ,121 ,6090 
4128754600,경기도 고양시 일산서구 탄현2동,읍면동,탄현2동,2131,14287 ,10927 ,5977 ,4494 ,283 ,5 ,72 ,5 ,0 ,1 ,5 ,12 ,3 ,1 ,10858 ,69 ,3360 
4128755000,경기도 고양시 일산서구 주엽1동,읍면동,주엽1동,2131,21604 ,17048 ,8147 ,8294 ,391 ,7 ,60 ,3 ,2 ,4 ,8 ,4 ,5 ,3 ,16928 ,120 ,4556 
4128756000,경기도 고양시 일산서구 주엽2동,읍면동,주엽2동,2131,21885 ,17116 ,8110 ,8329 ,438 ,9 ,67 ,4 ,1 ,6 ,22 ,6 ,1 ,8 ,17001 ,115 ,4769 
4128757000,경기도 고양시 일산서구 대화동,읍면동,대화동,2131,28571 ,21266 ,10441 ,9883 ,578 ,9 ,106 ,10 ,2 ,10 ,18 ,26 ,2 ,9 ,21094 ,172 ,7305 
4128758000,경기도 고양시 일산서구 송포동,읍면동,송포동,2131,16103 ,12597 ,5959 ,6200 ,298 ,6 ,50 ,1 ,0 ,1 ,6 ,5 ,1 ,4 ,12531 ,66 ,3506 
4128760000,경기도 고양시 일산서구 덕이동,읍면동,덕이동,2131,22419 ,15988 ,8116 ,7296 ,338 ,6 ,111 ,2 ,0 ,4 ,14 ,9 ,2 ,4 ,15902 ,86 ,6431 
4128761000,경기도 고양시 일산서구 가좌동,읍면동,가좌동,2131,14822 ,11471 ,5699 ,5327 ,312 ,6 ,52 ,4 ,3 ,1 ,5 ,3 ,2 ,0 ,11414 ,57 ,3351 
4129000000,경기도 과천시 ,시군구,과천시,21321,63841 ,54194 ,21072 ,30934 ,1314 ,30 ,228 ,19 ,10 ,20 ,28 ,31 ,7 ,12 ,53705 ,489 ,9647 
4129051000,경기도 과천시 중앙동,읍면동,중앙동,2132,8449 ,7174 ,2422 ,4502 ,167 ,1 ,14 ,0 ,1 ,6 ,4 ,3 ,0 ,2 ,7122 ,52 ,1275 
4129052000,경기도 과천시 갈현동,읍면동,갈현동,2132,11905 ,10079 ,3819 ,5892 ,237 ,4 ,36 ,2 ,3 ,5 ,9 ,3 ,2 ,0 ,10012 ,67 ,1826 
4129053000,경기도 과천시 별양동,읍면동,별양동,2132,12149 ,10240 ,3733 ,6114 ,244 ,6 ,45 ,4 ,1 ,2 ,2 ,6 ,3 ,0 ,10160 ,80 ,1909 
4129054000,경기도 과천시 부림동,읍면동,부림동,2132,11435 ,9637 ,3682 ,5573 ,245 ,3 ,34 ,5 ,1 ,3 ,4 ,8 ,0 ,2 ,9560 ,77 ,1798 
4129055000,경기도 과천시 과천동,읍면동,과천동,2132,6702 ,5099 ,2077 ,2828 ,104 ,6 ,31 ,5 ,1 ,0 ,4 ,3 ,1 ,1 ,5061 ,38 ,1603 
4129056000,경기도 과천시 문원동,읍면동,문원동,2132,5784 ,4751 ,2225 ,2312 ,124 ,5 ,26 ,1 ,3 ,3 ,4 ,2 ,1 ,3 ,4709 ,42 ,1033 
4131000000,경기도 구리시 ,시군구,구리시,21331,164281 ,127688 ,63465 ,58865 ,3023 ,36 ,878 ,31 ,18 ,32 ,107 ,117 ,28 ,54 ,126654 ,1034 ,36593 
4131051000,경기도 구리시 갈매동,읍면동,갈매동,2133,21819 ,16821 ,9096 ,7139 ,356 ,5 ,79 ,3 ,0 ,1 ,13 ,13 ,3 ,5 ,16713 ,108 ,4998 
4131052000,경기도 구리시 동구동,읍면동,동구동,2133,28669 ,22620 ,11221 ,10444 ,585 ,1 ,121 ,4 ,5 ,8 ,22 ,20 ,4 ,11 ,22446 ,174 ,6049 
4131053000,경기도 구리시 인창동,읍면동,인창동,2133,18101 ,13921 ,6932 ,6431 ,312 ,8 ,98 ,4 ,2 ,2 ,14 ,10 ,4 ,6 ,13823 ,98 ,4180 
4131054100,경기도 구리시 교문1동,읍면동,교문1동,2133,13748 ,9403 ,4406 ,4629 ,198 ,4 ,74 ,1 ,1 ,3 ,9 ,8 ,1 ,5 ,9339 ,64 ,4345 
4131054200,경기도 구리시 교문2동,읍면동,교문2동,2133,15535 ,12338 ,5692 ,6149 ,320 ,4 ,60 ,1 ,1 ,2 ,8 ,6 ,3 ,4 ,12250 ,88 ,3197 
4131057000,경기도 구리시 수택1동,읍면동,수택1동,2133,13699 ,9764 ,4713 ,4649 ,200 ,4 ,82 ,3 ,2 ,0 ,11 ,9 ,0 ,1 ,9674 ,90 ,3935 
4131058000,경기도 구리시 수택2동,읍면동,수택2동,2133,19831 ,14031 ,6965 ,6464 ,312 ,4 ,142 ,2 ,2 ,4 ,14 ,18 ,5 ,7 ,13939 ,92 ,5800 
4131059000,경기도 구리시 수택3동,읍면동,수택3동,2133,18289 ,14444 ,6975 ,6887 ,380 ,3 ,69 ,4 ,2 ,6 ,11 ,4 ,1 ,4 ,14346 ,98 ,3845 
4136000000,경기도 남양주시 ,시군구,남양주시,,608146 ,460518 ,239179 ,203075 ,10089 ,186 ,3326 ,100 ,56 ,107 ,322 ,388 ,97 ,156 ,457081 ,3437 ,147628 
4136025000,경기도 남양주시 와부읍,읍면동,와부읍,2136,46311 ,36730 ,17621 ,17715 ,841 ,6 ,192 ,13 ,5 ,12 ,28 ,31 ,9 ,14 ,36487 ,243 ,9581 
4136025300,경기도 남양주시 진접읍,읍면동,진접읍,2135,69463 ,48653 ,26248 ,20587 ,949 ,23 ,398 ,8 ,7 ,13 ,35 ,43 ,9 ,13 ,48333 ,320 ,20810 
4136025600,경기도 남양주시 화도읍,읍면동,화도읍,2134,88430 ,59963 ,32482 ,25135 ,1243 ,17 ,549 ,11 ,6 ,10 ,36 ,50 ,12 ,22 ,59573 ,390 ,28467 
4136025700,경기도 남양주시 화도읍동부출장소,읍면동,,,#N/A,#N/A,#N/A,#N/A,#N/A,#N/A,#N/A,#N/A,#N/A,#N/A,#N/A,#N/A,#N/A,#N/A,#N/A,#N/A,#N/A
4136025800,경기도 남양주시 화도읍남부출장소,읍면동,,,#N/A,#N/A,#N/A,#N/A,#N/A,#N/A,#N/A,#N/A,#N/A,#N/A,#N/A,#N/A,#N/A,#N/A,#N/A,#N/A,#N/A
4136025900,경기도 남양주시 진건읍,읍면동,진건읍,2136,19561 ,14132 ,6684 ,6871 ,294 ,8 ,110 ,5 ,2 ,7 ,9 ,15 ,6 ,3 ,14014 ,118 ,5429 
4136026200,경기도 남양주시 오남읍,읍면동,오남읍,2135,41590 ,28769 ,16082 ,11582 ,632 ,11 ,235 ,7 ,3 ,2 ,24 ,22 ,4 ,9 ,28613 ,156 ,12821 
4136026500,경기도 남양주시 퇴계원읍,읍면동,퇴계원읍,2136,23419 ,17490 ,8751 ,8026 ,367 ,7 ,136 ,7 ,2 ,5 ,23 ,13 ,4 ,6 ,17347 ,143 ,5929 
4136031000,경기도 남양주시 별내면,읍면동,별내면,2135,16117 ,12205 ,6493 ,5255 ,251 ,7 ,70 ,2 ,2 ,4 ,13 ,9 ,2 ,2 ,12110 ,95 ,3912 
4136034000,경기도 남양주시 수동면,읍면동,수동면,2134,8421 ,6299 ,2837 ,3192 ,117 ,4 ,48 ,4 ,5 ,2 ,6 ,4 ,3 ,9 ,6231 ,68 ,2122 
4136036000,경기도 남양주시 조안면,읍면동,조안면,2136,3271 ,2492 ,933 ,1462 ,50 ,0 ,20 ,1 ,0 ,0 ,7 ,4 ,2 ,0 ,2479 ,13 ,779 
4136051000,경기도 남양주시 호평동,읍면동,호평동,2134,42438 ,32132 ,17359 ,13607 ,693 ,8 ,203 ,5 ,3 ,7 ,16 ,24 ,7 ,8 ,31940 ,192 ,10306 
4136052000,경기도 남양주시 평내동,읍면동,평내동,2134,27175 ,20369 ,11318 ,8314 ,432 ,10 ,120 ,2 ,1 ,6 ,22 ,5 ,2 ,4 ,20236 ,133 ,6806 
4136053000,경기도 남양주시 금곡동,읍면동,금곡동,2136,16617 ,12062 ,5629 ,5929 ,262 ,2 ,106 ,1 ,3 ,2 ,13 ,13 ,4 ,8 ,11972 ,90 ,4555 
4136054000,경기도 남양주시 양정동,읍면동,양정동,2136,4225 ,3348 ,1446 ,1795 ,51 ,0 ,29 ,0 ,0 ,1 ,1 ,1 ,1 ,0 ,3325 ,23 ,877 
4136054500,경기도 남양주시 다산1동,읍면동,다산1동,2136,62579 ,47964 ,24224 ,21875 ,1199 ,12 ,257 ,9 ,4 ,9 ,35 ,29 ,8 ,10 ,47671 ,293 ,14615 
4136056500,경기도 남양주시 다산2동,읍면동,다산2동,2136,26335 ,20930 ,10529 ,9647 ,484 ,4 ,86 ,4 ,0 ,2 ,6 ,23 ,2 ,3 ,20790 ,140 ,5405 
4136057000,경기도 남양주시 별내동,읍면동,별내동,2135,56945 ,42552 ,21856 ,19078 ,966 ,20 ,244 ,8 ,6 ,10 ,26 ,25 ,13 ,11 ,42263 ,289 ,14393 
4137000000,경기도 오산시 ,시군구,오산시,21371,188297 ,135108 ,72877 ,55793 ,3352 ,65 ,1427 ,38 ,12 ,17 ,74 ,143 ,26 ,58 ,133882 ,1226 ,53189 
4137051000,경기도 오산시 중앙동,읍면동,중앙동,2137,27123 ,20145 ,10740 ,8524 ,503 ,6 ,162 ,3 ,1 ,2 ,12 ,12 ,7 ,7 ,19979 ,166 ,6978 
4137053000,경기도 오산시 남촌동,읍면동,남촌동,2137,18141 ,9648 ,5164 ,3946 ,205 ,5 ,188 ,2 ,1 ,1 ,5 ,11 ,1 ,6 ,9535 ,113 ,8493 
4137054000,경기도 오산시 신장동,읍면동,신장동,2137,42362 ,29348 ,16084 ,11973 ,705 ,13 ,280 ,11 ,2 ,6 ,14 ,31 ,3 ,11 ,29133 ,215 ,13014 
4137055000,경기도 오산시 세마동,읍면동,세마동,2137,23856 ,18280 ,9739 ,7726 ,481 ,6 ,153 ,6 ,3 ,2 ,8 ,19 ,2 ,6 ,18151 ,129 ,5576 
4137056000,경기도 오산시 초평동,읍면동,초평동,2137,12833 ,8966 ,4964 ,3553 ,225 ,7 ,112 ,3 ,0 ,0 ,7 ,10 ,2 ,3 ,8886 ,80 ,3867 
4137057000,경기도 오산시 대원동,읍면동,대원동,2137,47868 ,32788 ,17579 ,13650 ,842 ,16 ,331 ,7 ,2 ,3 ,24 ,32 ,5 ,18 ,32509 ,279 ,15080 
4139000000,경기도 시흥시 ,시군구,시흥시,,424723 ,317197 ,178462 ,125544 ,7082 ,151 ,2682 ,47 ,51 ,50 ,218 ,285 ,57 ,136 ,314765 ,2432 ,107526 
4139051000,경기도 시흥시 대야동,읍면동,대야동,2138,35084 ,26230 ,13820 ,11307 ,629 ,10 ,177 ,5 ,5 ,6 ,24 ,25 ,6 ,10 ,26024 ,206 ,8854 
4139052000,경기도 시흥시 신천동,읍면동,신천동,2138,29385 ,20119 ,10924 ,8309 ,442 ,7 ,195 ,4 ,1 ,2 ,19 ,19 ,9 ,12 ,19943 ,176 ,9266 
4139053100,경기도 시흥시 신현동,읍면동,신현동,2138,8825 ,6770 ,3377 ,3120 ,132 ,4 ,63 ,1 ,0 ,0 ,3 ,9 ,1 ,4 ,6714 ,56 ,2055 
4139054000,경기도 시흥시 은행동,읍면동,은행동,2138,40263 ,31078 ,17950 ,11836 ,780 ,11 ,233 ,3 ,3 ,3 ,15 ,25 ,2 ,9 ,30870 ,208 ,9185 
4139055000,경기도 시흥시 매화동,읍면동,매화동,2138,10308 ,7579 ,4193 ,3117 ,111 ,6 ,64 ,3 ,2 ,0 ,12 ,8 ,1 ,5 ,7522 ,57 ,2729 
4139057000,경기도 시흥시 목감동,읍면동,목감동,2138,30260 ,23120 ,12955 ,9289 ,514 ,12 ,138 ,2 ,6 ,6 ,12 ,20 ,1 ,8 ,22963 ,157 ,7140 
4139058100,경기도 시흥시 군자동,읍면동,군자동,2139,17207 ,11620 ,6505 ,4579 ,243 ,10 ,132 ,2 ,3 ,5 ,15 ,14 ,6 ,9 ,11523 ,97 ,5587 
4139058200,경기도 시흥시 월곶동,읍면동,월곶동,2139,13087 ,9318 ,5152 ,3825 ,166 ,6 ,89 ,1 ,4 ,2 ,9 ,11 ,1 ,1 ,9267 ,51 ,3769 
4139058900,경기도 시흥시 정왕본동,읍면동,정왕본동,2139,17355 ,9845 ,5689 ,3711 ,185 ,13 ,149 ,0 ,0 ,4 ,10 ,5 ,0 ,4 ,9770 ,75 ,7510 
4139059100,경기도 시흥시 정왕1동,읍면동,정왕1동,2139,18501 ,11426 ,6694 ,4242 ,225 ,5 ,132 ,2 ,3 ,0 ,12 ,12 ,3 ,6 ,11336 ,90 ,7075 
4139059200,경기도 시흥시 정왕2동,읍면동,정왕2동,2139,24577 ,16674 ,9858 ,6109 ,386 ,10 ,150 ,3 ,3 ,2 ,12 ,17 ,3 ,10 ,16563 ,111 ,7903 
4139059300,경기도 시흥시 정왕3동,읍면동,정왕3동,2139,19660 ,13675 ,8113 ,5027 ,274 ,7 ,125 ,3 ,1 ,2 ,8 ,11 ,3 ,9 ,13583 ,92 ,5985 
4139059400,경기도 시흥시 정왕4동,읍면동,정왕4동,2139,16116 ,12288 ,7223 ,4572 ,276 ,4 ,96 ,2 ,3 ,0 ,7 ,10 ,1 ,4 ,12198 ,90 ,3828 
4139059600,경기도 시흥시 배곧1동,읍면동,배곧1동,2139,24075 ,18851 ,11396 ,6789 ,423 ,4 ,117 ,0 ,2 ,2 ,10 ,8 ,2 ,11 ,18764 ,87 ,5224 
4139059700,경기도 시흥시 배곧2동,읍면동,배곧2동,2139,24510 ,18279 ,10452 ,7156 ,378 ,8 ,137 ,0 ,2 ,1 ,5 ,8 ,0 ,5 ,18152 ,127 ,6231 
4139062100,경기도 시흥시 과림동,읍면동,과림동,2138,1973 ,1598 ,679 ,874 ,22 ,0 ,7 ,0 ,0 ,0 ,3 ,2 ,0 ,0 ,1587 ,11 ,375 
4139063000,경기도 시흥시 연성동,읍면동,연성동,2138,18361 ,13994 ,8075 ,5345 ,357 ,2 ,80 ,1 ,2 ,2 ,13 ,12 ,3 ,4 ,13896 ,98 ,4367 
4139063100,경기도 시흥시 장곡동,읍면동,장곡동,2138,23013 ,17320 ,9906 ,6763 ,420 ,9 ,95 ,1 ,4 ,2 ,5 ,13 ,5 ,8 ,17231 ,89 ,5693 
4139064000,경기도 시흥시 능곡동,읍면동,능곡동,2138,18442 ,14134 ,7697 ,5911 ,312 ,4 ,84 ,2 ,1 ,4 ,7 ,15 ,4 ,1 ,14042 ,92 ,4308 
4141000000,경기도 군포시 ,시군구,군포시,21401,229884 ,183089 ,94891 ,80277 ,4593 ,79 ,1185 ,47 ,24 ,42 ,118 ,120 ,35 ,58 ,181469 ,1620 ,46795 
4141051000,경기도 군포시 군포1동,읍면동,군포1동,2140,25643 ,18383 ,9263 ,8306 ,429 ,16 ,169 ,2 ,4 ,5 ,11 ,12 ,0 ,8 ,18225 ,158 ,7260 
4141052000,경기도 군포시 군포2동,읍면동,군포2동,2140,34189 ,27138 ,14440 ,11559 ,691 ,4 ,147 ,11 ,1 ,5 ,18 ,13 ,5 ,7 ,26901 ,237 ,7051 
4141054000,경기도 군포시 산본1동,읍면동,산본1동,2140,13061 ,9499 ,4683 ,4391 ,227 ,8 ,69 ,2 ,3 ,5 ,9 ,6 ,3 ,4 ,9410 ,89 ,3562 
4141055000,경기도 군포시 산본2동,읍면동,산본2동,2140,19871 ,16110 ,7675 ,7820 ,385 ,9 ,76 ,2 ,1 ,7 ,6 ,6 ,2 ,4 ,15993 ,117 ,3761 
4141056000,경기도 군포시 금정동,읍면동,금정동,2140,15067 ,10863 ,5696 ,4694 ,242 ,3 ,101 ,4 ,3 ,3 ,12 ,6 ,3 ,3 ,10770 ,93 ,4204 
4141057000,경기도 군포시 재궁동,읍면동,재궁동,2140,16633 ,12987 ,6799 ,5603 ,334 ,6 ,86 ,1 ,0 ,3 ,11 ,11 ,3 ,3 ,12860 ,127 ,3646 
4141058000,경기도 군포시 오금동,읍면동,오금동,2140,16335 ,13121 ,6923 ,5654 ,337 ,6 ,62 ,3 ,2 ,3 ,7 ,7 ,3 ,3 ,13010 ,111 ,3214 
4141059000,경기도 군포시 수리동,읍면동,수리동,2140,12862 ,10216 ,5166 ,4624 ,270 ,1 ,53 ,7 ,0 ,2 ,7 ,7 ,3 ,3 ,10143 ,73 ,2646 
4141060000,경기도 군포시 궁내동,읍면동,궁내동,2140,14861 ,12230 ,6359 ,5389 ,332 ,2 ,47 ,0 ,2 ,2 ,7 ,8 ,2 ,3 ,12153 ,77 ,2631 
4141061000,경기도 군포시 대야동,읍면동,대야동,2140,7943 ,6463 ,3544 ,2658 ,147 ,5 ,46 ,1 ,0 ,0 ,9 ,5 ,2 ,1 ,6418 ,45 ,1480 
4141062000,경기도 군포시 광정동,읍면동,광정동,2140,18629 ,14607 ,7287 ,6721 ,356 ,8 ,76 ,3 ,5 ,4 ,7 ,5 ,2 ,5 ,14479 ,128 ,4022 
4141063000,경기도 군포시 송부동,읍면동,송부동,2140,14815 ,11832 ,6591 ,4740 ,309 ,1 ,80 ,3 ,0 ,2 ,7 ,11 ,1 ,3 ,11748 ,84 ,2983 
4143000000,경기도 의왕시 ,시군구,의왕시,21322,139712 ,113105 ,54997 ,53556 ,2717 ,52 ,636 ,30 ,22 ,15 ,77 ,84 ,17 ,35 ,112238 ,867 ,26607 
4143051000,경기도 의왕시 고천동,읍면동,고천동,2132,12052 ,9558 ,4529 ,4612 ,238 ,5 ,69 ,7 ,2 ,2 ,7 ,15 ,0 ,3 ,9489 ,69 ,2494 
4143052000,경기도 의왕시 부곡동,읍면동,부곡동,2132,22988 ,17412 ,9023 ,7629 ,413 ,12 ,136 ,5 ,8 ,2 ,13 ,8 ,4 ,9 ,17262 ,150 ,5576 
4143053000,경기도 의왕시 오전동,읍면동,오전동,2132,28791 ,22384 ,11003 ,10542 ,491 ,9 ,118 ,4 ,4 ,2 ,27 ,17 ,4 ,7 ,22228 ,156 ,6407 
4143054000,경기도 의왕시 내손1동,읍면동,내손1동,2132,15120 ,12073 ,5451 ,6138 ,309 ,4 ,61 ,3 ,4 ,2 ,8 ,9 ,1 ,2 ,11992 ,81 ,3047 
4143055000,경기도 의왕시 내손2동,읍면동,내손2동,2132,17007 ,13752 ,6561 ,6696 ,327 ,4 ,48 ,5 ,1 ,2 ,5 ,3 ,3 ,3 ,13658 ,94 ,3255 
4143056000,경기도 의왕시 청계동,읍면동,청계동,2132,26525 ,20961 ,9654 ,10503 ,508 ,11 ,105 ,3 ,1 ,4 ,15 ,15 ,3 ,4 ,20826 ,135 ,5564 
4145000000,경기도 하남시 ,시군구,하남시,21411,265087 ,208858 ,101106 ,100088 ,4624 ,81 ,1025 ,39 ,27 ,35 ,114 ,156 ,37 ,39 ,207371 ,1487 ,56229 
4145051000,경기도 하남시 천현동,읍면동,천현동,2141,6158 ,4366 ,1755 ,2493 ,56 ,2 ,26 ,0 ,0 ,1 ,4 ,3 ,0 ,0 ,4340 ,26 ,1792 
4145052000,경기도 하남시 신장1동,읍면동,신장1동,2141,7606 ,5842 ,2834 ,2792 ,100 ,2 ,52 ,1 ,4 ,3 ,6 ,9 ,5 ,1 ,5809 ,33 ,1764 
4145053000,경기도 하남시 신장2동,읍면동,신장2동,2141,34707 ,26393 ,11836 ,13681 ,520 ,11 ,124 ,3 ,3 ,5 ,14 ,16 ,2 ,9 ,26224 ,169 ,8314 
4145054000,경기도 하남시 덕풍1동,읍면동,덕풍1동,2141,12444 ,9351 ,4510 ,4506 ,179 ,2 ,53 ,3 ,1 ,3 ,7 ,15 ,3 ,2 ,9284 ,67 ,3093 
4145055000,경기도 하남시 덕풍2동,읍면동,덕풍2동,2141,15599 ,11340 ,5415 ,5512 ,224 ,7 ,79 ,3 ,0 ,0 ,10 ,12 ,3 ,3 ,11268 ,72 ,4259 
4145056000,경기도 하남시 덕풍3동,읍면동,덕풍3동,2141,19525 ,14730 ,7021 ,7188 ,329 ,5 ,74 ,1 ,1 ,2 ,14 ,9 ,3 ,4 ,14651 ,79 ,4795 
4145057000,경기도 하남시 풍산동,읍면동,풍산동,2141,18834 ,14587 ,7384 ,6705 ,326 ,3 ,53 ,2 ,3 ,2 ,2 ,7 ,3 ,3 ,14493 ,94 ,4247 
4145058000,경기도 하남시 감북동,읍면동,감북동,2141,2670 ,2117 ,897 ,1138 ,52 ,1 ,11 ,0 ,0 ,1 ,1 ,2 ,1 ,0 ,2104 ,13 ,553 
4145058200,경기도 하남시 감일동,읍면동,감일동,2141,20315 ,16033 ,8383 ,7023 ,406 ,2 ,78 ,2 ,0 ,3 ,8 ,17 ,2 ,4 ,15928 ,105 ,4282 
4145058500,경기도 하남시 위례동,읍면동,위례동,2141,17810 ,14331 ,5899 ,7974 ,325 ,4 ,36 ,1 ,3 ,0 ,5 ,1 ,1 ,0 ,14249 ,82 ,3479 
4145059000,경기도 하남시 춘궁동,읍면동,춘궁동,2141,3574 ,2752 ,1020 ,1658 ,43 ,0 ,15 ,0 ,0 ,1 ,2 ,5 ,1 ,1 ,2746 ,6 ,822 
4145060000,경기도 하남시 초이동,읍면동,초이동,2141,2931 ,2145 ,905 ,1171 ,36 ,0 ,15 ,0 ,0 ,0 ,2 ,0 ,0 ,0 ,2129 ,16 ,786 
4145061000,경기도 하남시 미사1동,읍면동,미사1동,2141,38018 ,27534 ,13975 ,12398 ,741 ,8 ,138 ,6 ,4 ,6 ,14 ,12 ,6 ,4 ,27312 ,222 ,10484 
4145062000,경기도 하남시 미사2동,읍면동,미사2동,2141,33056 ,25920 ,13427 ,11604 ,584 ,11 ,88 ,10 ,4 ,3 ,15 ,18 ,5 ,4 ,25773 ,147 ,7136 
4146000000,경기도 용인시 ,시군구,용인시,,886987 ,702643 ,336628 ,339706 ,15219 ,252 ,3840 ,105 ,92 ,192 ,401 ,448 ,109 ,207 ,697199 ,5444 ,184344 
4146100000,경기도 용인시 처인구 ,행정구,용인시처인구,21421,220689 ,162420 ,80188 ,75105 ,3618 ,78 ,1532 ,33 ,27 ,44 ,105 ,162 ,46 ,69 ,161007 ,1413 ,58269 
4146125000,경기도 용인시 처인구 포곡읍,읍면동,포곡읍,2142,26527 ,18716 ,9956 ,7873 ,429 ,5 ,206 ,8 ,2 ,3 ,17 ,23 ,2 ,10 ,18534 ,182 ,7811 
4146125300,경기도 용인시 처인구 모현읍,읍면동,모현읍,2142,20126 ,14028 ,7077 ,6411 ,273 ,8 ,114 ,1 ,4 ,7 ,7 ,10 ,7 ,3 ,13922 ,106 ,6098 
4146125600,경기도 용인시 처인구 이동읍,읍면동,이동읍,2142,16403 ,11225 ,5575 ,5183 ,210 ,3 ,135 ,2 ,1 ,3 ,6 ,9 ,4 ,7 ,11138 ,87 ,5178 
4146125900,경기도 용인시 처인구 남사읍,읍면동,남사읍,2142,15875 ,11766 ,5784 ,5601 ,209 ,2 ,67 ,2 ,2 ,4 ,18 ,6 ,2 ,3 ,11700 ,66 ,4109 
4146134000,경기도 용인시 처인구 원삼면,읍면동,원삼면,2142,6564 ,4915 ,1796 ,2926 ,97 ,4 ,37 ,3 ,3 ,1 ,2 ,1 ,1 ,2 ,4873 ,42 ,1649 
4146135000,경기도 용인시 처인구 백암면,읍면동,백암면,2142,7413 ,5135 ,1941 ,2959 ,106 ,5 ,44 ,1 ,3 ,4 ,4 ,1 ,8 ,5 ,5081 ,54 ,2278 
4146136000,경기도 용인시 처인구 양지면,읍면동,양지면,2142,15088 ,10294 ,4724 ,5173 ,193 ,4 ,109 ,0 ,0 ,1 ,5 ,9 ,4 ,3 ,10225 ,69 ,4794 
4146151000,경기도 용인시 처인구 중앙동,읍면동,중앙동,2142,19697 ,13735 ,6423 ,6659 ,355 ,9 ,135 ,1 ,2 ,2 ,4 ,26 ,5 ,3 ,13624 ,111 ,5962 
4146152500,경기도 용인시 처인구 역북동,읍면동,역북동,2142,24299 ,17799 ,8954 ,8004 ,489 ,9 ,149 ,4 ,3 ,8 ,12 ,13 ,2 ,5 ,17652 ,147 ,6500 
4146152600,경기도 용인시 처인구 삼가동,읍면동,삼가동,2142,9586 ,7325 ,3619 ,3445 ,159 ,0 ,40 ,1 ,2 ,2 ,4 ,9 ,1 ,2 ,7284 ,41 ,2261 
4146153000,경기도 용인시 처인구 유림동,읍면동,유림동,2142,26658 ,18393 ,9953 ,7618 ,426 ,6 ,186 ,5 ,1 ,3 ,10 ,21 ,7 ,14 ,18250 ,143 ,8265 
4146154000,경기도 용인시 처인구 동부동,읍면동,동부동,2142,11591 ,8521 ,4055 ,4093 ,199 ,7 ,86 ,0 ,1 ,2 ,8 ,11 ,2 ,3 ,8467 ,54 ,3070 
4146300000,경기도 용인시 기흥구 ,행정구,용인시기흥구,21431,361753 ,289459 ,143279 ,135606 ,6267 ,93 ,1477 ,40 ,31 ,75 ,150 ,188 ,37 ,84 ,287327 ,2132 ,72294 
4146351000,경기도 용인시 기흥구 신갈동,읍면동,신갈동,2143,31087 ,24338 ,12404 ,10898 ,621 ,10 ,155 ,3 ,0 ,6 ,12 ,20 ,4 ,7 ,24140 ,198 ,6749 
4146351600,경기도 용인시 기흥구 영덕1동,읍면동,영덕1동,2143,21126 ,16450 ,8499 ,7394 ,374 ,3 ,61 ,0 ,1 ,6 ,8 ,3 ,2 ,3 ,16354 ,96 ,4676 
4146351700,경기도 용인시 기흥구 영덕2동,읍면동,영덕2동,2143,12957 ,10129 ,5129 ,4619 ,232 ,3 ,64 ,2 ,0 ,5 ,2 ,6 ,1 ,4 ,10067 ,62 ,2828 
4146352000,경기도 용인시 기흥구 구갈동,읍면동,구갈동,2143,29374 ,22230 ,10876 ,10445 ,560 ,7 ,126 ,2 ,1 ,6 ,7 ,12 ,3 ,6 ,22051 ,179 ,7144 
4146353000,경기도 용인시 기흥구 상갈동,읍면동,상갈동,2143,10886 ,8432 ,4471 ,3607 ,217 ,4 ,54 ,0 ,1 ,1 ,5 ,7 ,2 ,4 ,8373 ,59 ,2454 
4146353500,경기도 용인시 기흥구 보라동,읍면동,보라동,2143,24875 ,19275 ,10040 ,8626 ,350 ,9 ,94 ,5 ,3 ,6 ,7 ,7 ,1 ,4 ,19152 ,123 ,5600 
4146354000,경기도 용인시 기흥구 기흥동,읍면동,기흥동,2143,15401 ,10952 ,5121 ,5457 ,212 ,4 ,70 ,2 ,4 ,4 ,14 ,4 ,1 ,5 ,10898 ,54 ,4449 
4146355000,경기도 용인시 기흥구 서농동,읍면동,서농동,2143,18396 ,14317 ,7132 ,6602 ,343 ,3 ,70 ,1 ,2 ,1 ,6 ,8 ,2 ,6 ,14176 ,141 ,4079 
4146356000,경기도 용인시 기흥구 구성동,읍면동,구성동,2145,30386 ,23800 ,10998 ,12100 ,421 ,7 ,106 ,3 ,2 ,6 ,11 ,17 ,3 ,3 ,23677 ,123 ,6586 
4146357000,경기도 용인시 기흥구 마북동,읍면동,마북동,2145,24323 ,19389 ,8275 ,10538 ,341 ,7 ,88 ,1 ,0 ,3 ,10 ,9 ,3 ,2 ,19277 ,112 ,4934 
4146357200,경기도 용인시 기흥구 동백1동,읍면동,동백1동,2145,22888 ,18163 ,10431 ,7082 ,432 ,7 ,75 ,3 ,6 ,4 ,12 ,19 ,1 ,1 ,18073 ,90 ,4725 
4146357500,경기도 용인시 기흥구 동백2동,읍면동,동백2동,2145,19816 ,15915 ,8339 ,7079 ,314 ,3 ,64 ,1 ,4 ,1 ,7 ,17 ,0 ,2 ,15831 ,84 ,3901 
4146357700,경기도 용인시 기흥구 동백3동,읍면동,동백3동,2143,17737 ,13865 ,6589 ,6860 ,270 ,4 ,43 ,1 ,0 ,3 ,15 ,5 ,1 ,1 ,13792 ,73 ,3872 
4146358600,경기도 용인시 기흥구 상하동,읍면동,상하동,2143,18410 ,14158 ,7274 ,6372 ,302 ,3 ,78 ,4 ,0 ,11 ,11 ,9 ,3 ,5 ,14072 ,86 ,4252 
4146359000,경기도 용인시 기흥구 보정동,읍면동,보정동,2145,24880 ,19625 ,8224 ,10788 ,387 ,4 ,74 ,2 ,3 ,4 ,13 ,3 ,6 ,7 ,19515 ,110 ,5255 
4146500000,경기도 용인시 수지구 ,행정구,용인시수지구,21441,304545 ,250764 ,113161 ,128995 ,5334 ,81 ,831 ,32 ,34 ,73 ,146 ,98 ,26 ,54 ,248865 ,1899 ,53781 
4146551000,경기도 용인시 수지구 풍덕천1동,읍면동,풍덕천1동,2144,29379 ,23303 ,10876 ,11512 ,548 ,10 ,97 ,3 ,3 ,8 ,16 ,16 ,2 ,6 ,23097 ,206 ,6076 
4146552000,경기도 용인시 수지구 풍덕천2동,읍면동,풍덕천2동,2144,27836 ,22446 ,10953 ,10657 ,576 ,7 ,59 ,1 ,2 ,4 ,11 ,5 ,3 ,5 ,22283 ,163 ,5390 
4146553000,경기도 용인시 수지구 신봉동,읍면동,신봉동,2144,28003 ,22718 ,9925 ,12127 ,406 ,5 ,80 ,3 ,3 ,11 ,17 ,4 ,3 ,6 ,22590 ,128 ,5285 
4146554000,경기도 용인시 수지구 죽전1동,읍면동,죽전1동,2145,21814 ,17614 ,8205 ,8887 ,335 ,5 ,51 ,2 ,0 ,4 ,11 ,10 ,0 ,5 ,17515 ,99 ,4200 
4146555000,경기도 용인시 수지구 죽전2동,읍면동,죽전2동,2144,12983 ,10253 ,4661 ,5237 ,245 ,3 ,24 ,1 ,3 ,1 ,9 ,4 ,1 ,1 ,10190 ,63 ,2730 
4146555500,경기도 용인시 수지구 죽전3동,읍면동,죽전3동,2145,17842 ,13663 ,6463 ,6660 ,337 ,5 ,51 ,1 ,2 ,6 ,9 ,14 ,2 ,2 ,13552 ,111 ,4179 
4146556000,경기도 용인시 수지구 동천동,읍면동,동천동,2144,35443 ,28864 ,13127 ,14792 ,633 ,5 ,78 ,6 ,3 ,9 ,16 ,15 ,1 ,6 ,28691 ,173 ,6579 
4146557000,경기도 용인시 수지구 상현1동,읍면동,상현1동,2144,15166 ,12484 ,5629 ,6451 ,261 ,6 ,38 ,1 ,5 ,2 ,5 ,6 ,1 ,2 ,12407 ,77 ,2682 
4146558000,경기도 용인시 수지구 상현2동,읍면동,상현2동,2145,24599 ,20236 ,9340 ,10288 ,381 ,4 ,81 ,3 ,2 ,2 ,11 ,5 ,1 ,4 ,20122 ,114 ,4363 
4146558500,경기도 용인시 수지구 상현3동,읍면동,상현3동,-,18802 ,14936 ,6858 ,7531 ,352 ,4 ,51 ,2 ,4 ,5 ,6 ,2 ,3 ,3 ,14821 ,115 ,3866 
4146559000,경기도 용인시 수지구 성복동,읍면동,성복동,2144,38699 ,31215 ,11073 ,19320 ,523 ,5 ,72 ,1 ,4 ,17 ,25 ,8 ,3 ,5 ,31056 ,159 ,7484 
4148000000,경기도 파주시 ,시군구,파주시,,401260 ,297278 ,157155 ,126763 ,7176 ,154 ,2566 ,98 ,45 ,88 ,211 ,342 ,84 ,119 ,294801 ,2477 ,103982 
4148025000,경기도 파주시 문산읍,읍면동,문산읍,2147,36465 ,24748 ,12566 ,11038 ,551 ,10 ,280 ,8 ,3 ,14 ,18 ,34 ,13 ,14 ,24549 ,199 ,11717 
4148025300,경기도 파주시 파주읍,읍면동,파주읍,2147,11569 ,7807 ,3532 ,3899 ,159 ,10 ,108 ,2 ,1 ,1 ,5 ,5 ,4 ,7 ,7733 ,74 ,3762 
4148025600,경기도 파주시 법원읍,읍면동,법원읍,2147,9134 ,6389 ,2715 ,3328 ,146 ,3 ,84 ,4 ,1 ,2 ,7 ,13 ,5 ,5 ,6313 ,76 ,2745 
4148026200,경기도 파주시 조리읍,읍면동,조리읍,2146,23799 ,16927 ,8414 ,7838 ,352 ,4 ,146 ,5 ,3 ,5 ,11 ,18 ,4 ,3 ,16803 ,124 ,6872 
4148031000,경기도 파주시 월롱면,읍면동,월롱면,2147,8968 ,6135 ,2782 ,3043 ,132 ,3 ,83 ,1 ,2 ,1 ,4 ,5 ,2 ,6 ,6064 ,71 ,2833 
4148032000,경기도 파주시 탄현면,읍면동,탄현면,2146,11461 ,8250 ,4126 ,3777 ,181 ,9 ,69 ,2 ,2 ,2 ,5 ,8 ,2 ,6 ,8189 ,61 ,3211 
4148035000,경기도 파주시 광탄면,읍면동,광탄면,2146,9892 ,6996 ,2943 ,3735 ,172 ,5 ,68 ,1 ,0 ,3 ,9 ,6 ,1 ,2 ,6945 ,51 ,2896 
4148036000,경기도 파주시 파평면,읍면동,파평면,2147,3763 ,2829 ,1134 ,1547 ,83 ,1 ,29 ,1 ,1 ,1 ,2 ,3 ,4 ,4 ,2810 ,19 ,934 
4148037000,경기도 파주시 적성면,읍면동,적성면,2147,5950 ,4291 ,1590 ,2491 ,83 ,2 ,45 ,1 ,2 ,1 ,2 ,7 ,5 ,3 ,4232 ,59 ,1659 
4148039000,경기도 파주시 장단면,읍면동,장단면,2147,799 ,707 ,303 ,364 ,15 ,0 ,12 ,1 ,0 ,0 ,1 ,1 ,0 ,1 ,698 ,9 ,92 
4148051000,경기도 파주시 금촌1동,읍면동,금촌1동,2147,18839 ,12084 ,5897 ,5602 ,284 ,8 ,140 ,7 ,2 ,2 ,7 ,15 ,3 ,4 ,11971 ,113 ,6755 
4148052000,경기도 파주시 금촌2동,읍면동,금촌2동,2147,26231 ,19858 ,11052 ,7891 ,546 ,19 ,155 ,5 ,4 ,4 ,14 ,21 ,4 ,9 ,19724 ,134 ,6373 
4148053000,경기도 파주시 금촌3동,읍면동,금촌3동,2147,21466 ,15065 ,8018 ,6322 ,365 ,12 ,163 ,6 ,3 ,5 ,13 ,14 ,8 ,8 ,14937 ,128 ,6401 
4148054000,경기도 파주시 교하동,읍면동,교하동,2146,36293 ,26370 ,14544 ,10767 ,637 ,8 ,181 ,16 ,0 ,4 ,16 ,28 ,4 ,6 ,26211 ,159 ,9923 
4148055000,경기도 파주시 운정1동,읍면동,운정1동,2146,42425 ,32689 ,18600 ,12761 ,783 ,15 ,226 ,11 ,2 ,11 ,27 ,30 ,5 ,9 ,32480 ,209 ,9736 
4148056000,경기도 파주시 운정2동,읍면동,운정2동,2146,40922 ,30757 ,17748 ,11746 ,824 ,9 ,168 ,7 ,5 ,7 ,19 ,13 ,2 ,5 ,30553 ,204 ,10165 
4148057000,경기도 파주시 운정3동,읍면동,운정3동,2146,59473 ,42241 ,23701 ,16884 ,1005 ,14 ,256 ,9 ,3 ,13 ,27 ,41 ,6 ,12 ,41971 ,270 ,17232 
4150000000,경기도 이천시 ,시군구,이천시,21481,187895 ,137512 ,63562 ,67726 ,2995 ,68 ,1354 ,34 ,21 ,36 ,77 ,154 ,47 ,64 ,136138 ,1374 ,50383 
4150025000,경기도 이천시 장호원읍,읍면동,장호원읍,2148,11391 ,8154 ,3409 ,4419 ,160 ,7 ,61 ,0 ,0 ,5 ,2 ,4 ,7 ,2 ,8076 ,78 ,3237 
4150025300,경기도 이천시 부발읍,읍면동,부발읍,2148,26347 ,18347 ,9295 ,8281 ,387 ,8 ,166 ,1 ,2 ,2 ,9 ,20 ,6 ,13 ,18190 ,157 ,8000 
4150031000,경기도 이천시 신둔면,읍면동,신둔면,2148,11437 ,8360 ,3917 ,4110 ,178 ,1 ,65 ,1 ,2 ,3 ,13 ,8 ,1 ,1 ,8300 ,60 ,3077 
4150032000,경기도 이천시 백사면,읍면동,백사면,2148,8872 ,6125 ,2748 ,3123 ,120 ,2 ,61 ,2 ,4 ,1 ,6 ,6 ,2 ,4 ,6079 ,46 ,2747 
4150033000,경기도 이천시 호법면,읍면동,호법면,2148,4954 ,3598 ,1363 ,2088 ,70 ,1 ,33 ,1 ,0 ,0 ,1 ,6 ,5 ,1 ,3569 ,29 ,1356 
4150034000,경기도 이천시 마장면,읍면동,마장면,2148,11838 ,8456 ,3716 ,4295 ,201 ,7 ,118 ,2 ,0 ,1 ,4 ,5 ,5 ,0 ,8354 ,102 ,3382 
4150035000,경기도 이천시 대월면,읍면동,대월면,2148,12334 ,8661 ,4322 ,3927 ,196 ,3 ,99 ,4 ,0 ,2 ,4 ,9 ,2 ,4 ,8572 ,89 ,3673 
4150036000,경기도 이천시 모가면,읍면동,모가면,2148,4162 ,3208 ,1123 ,1977 ,45 ,0 ,26 ,0 ,1 ,1 ,3 ,2 ,0 ,2 ,3180 ,28 ,954 
4150037000,경기도 이천시 설성면,읍면동,설성면,2148,3750 ,2733 ,936 ,1693 ,45 ,3 ,25 ,0 ,0 ,2 ,2 ,2 ,1 ,1 ,2710 ,23 ,1017 
4150038000,경기도 이천시 율면,읍면동,율면,2148,2409 ,1810 ,719 ,1018 ,34 ,1 ,13 ,0 ,0 ,2 ,1 ,1 ,1 ,1 ,1791 ,19 ,599 
4150051000,경기도 이천시 창전동,읍면동,창전동,2148,15588 ,10796 ,4707 ,5593 ,236 ,8 ,106 ,6 ,2 ,2 ,8 ,19 ,3 ,4 ,10694 ,102 ,4792 
4150051500,경기도 이천시 증포동,읍면동,증포동,2148,37097 ,26200 ,13856 ,11263 ,599 ,13 ,222 ,8 ,1 ,1 ,10 ,29 ,5 ,6 ,26013 ,187 ,10897 
4150052000,경기도 이천시 중리동,읍면동,중리동,2148,12243 ,8551 ,3339 ,4821 ,170 ,1 ,97 ,2 ,1 ,4 ,5 ,14 ,1 ,4 ,8459 ,92 ,3692 
4150053000,경기도 이천시 관고동,읍면동,관고동,2148,9674 ,6956 ,3070 ,3606 ,147 ,2 ,65 ,0 ,0 ,2 ,2 ,9 ,3 ,3 ,6909 ,47 ,2718 
4155000000,경기도 안성시 ,시군구,안성시,21482,162452 ,117380 ,56723 ,54799 ,2892 ,87 ,1238 ,24 ,20 ,30 ,75 ,156 ,25 ,54 ,116123 ,1257 ,45072 
4155025000,경기도 안성시 공도읍,읍면동,공도읍,2149,43183 ,28526 ,15602 ,11563 ,693 ,12 ,291 ,6 ,3 ,11 ,14 ,36 ,5 ,9 ,28245 ,281 ,14657 
4155031000,경기도 안성시 보개면,읍면동,보개면,2149,5186 ,4054 ,1698 ,2164 ,88 ,2 ,32 ,0 ,3 ,1 ,2 ,7 ,0 ,5 ,4002 ,52 ,1132 
4155032000,경기도 안성시 금광면,읍면동,금광면,2149,6113 ,4565 ,2182 ,2152 ,105 ,5 ,45 ,1 ,0 ,1 ,6 ,10 ,1 ,5 ,4513 ,52 ,1548 
4155033000,경기도 안성시 서운면,읍면동,서운면,2149,3190 ,2446 ,1018 ,1300 ,55 ,3 ,27 ,0 ,0 ,0 ,3 ,6 ,0 ,1 ,2413 ,33 ,744 
4155034000,경기도 안성시 미양면,읍면동,미양면,2149,5152 ,3617 ,1675 ,1765 ,80 ,5 ,34 ,2 ,1 ,1 ,9 ,5 ,1 ,2 ,3580 ,37 ,1535 
4155035000,경기도 안성시 대덕면,읍면동,대덕면,2149,12480 ,8365 ,4231 ,3721 ,208 ,5 ,94 ,2 ,0 ,1 ,5 ,17 ,1 ,2 ,8287 ,78 ,4115 
4155036000,경기도 안성시 양성면,읍면동,양성면,2149,4619 ,3370 ,1317 ,1903 ,68 ,2 ,30 ,1 ,0 ,0 ,6 ,3 ,1 ,0 ,3331 ,39 ,1249 
4155038000,경기도 안성시 원곡면,읍면동,원곡면,2149,5253 ,3623 ,1610 ,1846 ,77 ,2 ,44 ,0 ,0 ,2 ,1 ,5 ,1 ,4 ,3592 ,31 ,1630 
4155039000,경기도 안성시 일죽면,읍면동,일죽면,2149,6198 ,4491 ,1693 ,2592 ,82 ,4 ,49 ,0 ,0 ,0 ,4 ,1 ,4 ,1 ,4430 ,61 ,1707 
4155040000,경기도 안성시 죽산면,읍면동,죽산면,2149,6012 ,4313 ,1757 ,2354 ,63 ,9 ,62 ,1 ,2 ,2 ,2 ,2 ,3 ,2 ,4259 ,54 ,1699 
4155041000,경기도 안성시 삼죽면,읍면동,삼죽면,2149,3093 ,2260 ,889 ,1257 ,52 ,2 ,22 ,0 ,2 ,2 ,1 ,5 ,0 ,1 ,2233 ,27 ,833 
4155042000,경기도 안성시 고삼면,읍면동,고삼면,2149,2276 ,1889 ,830 ,981 ,31 ,3 ,12 ,0 ,1 ,0 ,2 ,4 ,0 ,1 ,1865 ,24 ,387 
4155051000,경기도 안성시 안성1동,읍면동,안성1동,2149,10856 ,8007 ,3510 ,4099 ,214 ,10 ,72 ,2 ,1 ,3 ,6 ,7 ,1 ,4 ,7929 ,78 ,2849 
4155052000,경기도 안성시 안성2동,읍면동,안성2동,2149,19449 ,13590 ,6915 ,5983 ,374 ,9 ,148 ,1 ,3 ,1 ,4 ,11 ,1 ,8 ,13458 ,132 ,5859 
4155053000,경기도 안성시 안성3동,읍면동,안성3동,2149,16689 ,11774 ,5685 ,5450 ,383 ,7 ,102 ,4 ,1 ,1 ,5 ,18 ,3 ,5 ,11664 ,110 ,4915 
4157000000,경기도 김포시 ,시군구,김포시,,391889 ,302170 ,153206 ,136814 ,6905 ,114 ,2175 ,54 ,31 ,73 ,197 ,227 ,79 ,78 ,299953 ,2217 ,89719 
4157025000,경기도 김포시 통진읍,읍면동,통진읍,2151,23083 ,15514 ,7375 ,7419 ,303 ,9 ,231 ,5 ,3 ,2 ,10 ,18 ,5 ,7 ,15387 ,127 ,7569 
4157025300,경기도 김포시 고촌읍,읍면동,고촌읍,2150,34177 ,27375 ,13117 ,13258 ,650 ,6 ,134 ,2 ,6 ,7 ,22 ,14 ,3 ,5 ,27224 ,151 ,6802 
4157025600,경기도 김포시 양촌읍,읍면동,양촌읍,2151,22685 ,15739 ,7978 ,7131 ,303 ,4 ,172 ,3 ,3 ,9 ,10 ,13 ,9 ,6 ,15641 ,98 ,6946 
4157034000,경기도 김포시 대곶면,읍면동,대곶면,2151,8575 ,5996 ,2370 ,3418 ,95 ,3 ,51 ,0 ,0 ,1 ,5 ,8 ,2 ,2 ,5955 ,41 ,2579 
4157035000,경기도 김포시 월곶면,읍면동,월곶면,2151,5246 ,3833 ,1507 ,2120 ,65 ,6 ,57 ,2 ,1 ,4 ,3 ,8 ,2 ,2 ,3777 ,56 ,1413 
4157036000,경기도 김포시 하성면,읍면동,하성면,2151,7481 ,5501 ,2270 ,3022 ,89 ,1 ,63 ,0 ,0 ,2 ,3 ,1 ,2 ,1 ,5454 ,47 ,1980 
4157051500,경기도 김포시 김포본동,읍면동,김포본동,2150,43172 ,32903 ,16033 ,15493 ,824 ,12 ,210 ,7 ,1 ,9 ,25 ,17 ,10 ,5 ,32646 ,257 ,10269 
4157052500,경기도 김포시 장기본동,읍면동,장기본동,2151,26727 ,20378 ,10441 ,9211 ,448 ,8 ,109 ,2 ,1 ,3 ,14 ,13 ,6 ,2 ,20258 ,120 ,6349 
4157054000,경기도 김포시 사우동,읍면동,사우동,2150,21770 ,16920 ,8714 ,7526 ,419 ,8 ,99 ,3 ,0 ,1 ,12 ,16 ,4 ,2 ,16804 ,116 ,4850 
4157055000,경기도 김포시 풍무동,읍면동,풍무동,2150,43898 ,33644 ,17135 ,15282 ,728 ,12 ,191 ,7 ,3 ,16 ,27 ,24 ,4 ,7 ,33436 ,208 ,10254 
4157056000,경기도 김포시 장기동,읍면동,장기동,2150,30548 ,23650 ,12698 ,10079 ,560 ,15 ,133 ,6 ,2 ,4 ,9 ,12 ,7 ,4 ,23529 ,121 ,6898 
4157057000,경기도 김포시 구래동,읍면동,구래동,2151,32995 ,23774 ,13124 ,9663 ,572 ,13 ,188 ,3 ,1 ,4 ,16 ,16 ,4 ,8 ,23612 ,162 ,9221 
4157057500,경기도 김포시 마산동,읍면동,마산동,2151,25514 ,19237 ,10726 ,7734 ,465 ,5 ,128 ,4 ,2 ,2 ,10 ,11 ,8 ,4 ,19099 ,138 ,6277 
4157058000,경기도 김포시 운양동,읍면동,운양동,2151,33180 ,25409 ,13146 ,11338 ,613 ,3 ,119 ,2 ,1 ,3 ,18 ,14 ,4 ,6 ,25267 ,142 ,7771 
4159000000,경기도 화성시 ,시군구,화성시,,703896 ,542027 ,283324 ,236055 ,12955 ,194 ,4007 ,100 ,58 ,90 ,223 ,399 ,117 ,177 ,537699 ,4328 ,161869 
4159025300,경기도 화성시 봉담읍,읍면동,봉담읍,2152,60174 ,43807 ,24200 ,17640 ,1102 ,16 ,436 ,11 ,4 ,9 ,24 ,37 ,9 ,22 ,43510 ,297 ,16367 
4159025600,경기도 화성시 우정읍,읍면동,우정읍,2152,14523 ,10300 ,4975 ,4847 ,239 ,5 ,102 ,5 ,2 ,7 ,7 ,17 ,7 ,5 ,10218 ,82 ,4223 
4159025900,경기도 화성시 향남읍,읍면동,향남읍,2152,61719 ,41940 ,23936 ,16231 ,938 ,19 ,404 ,7 ,3 ,4 ,20 ,51 ,14 ,13 ,41640 ,300 ,19779 
4159026200,경기도 화성시 남양읍,읍면동,남양읍,2152,31571 ,21817 ,11079 ,9755 ,511 ,7 ,236 ,8 ,3 ,4 ,7 ,13 ,5 ,9 ,21637 ,180 ,9754 
4159031000,경기도 화성시 매송면,읍면동,매송면,2152,5976 ,4405 ,1873 ,2368 ,63 ,2 ,51 ,0 ,0 ,1 ,8 ,2 ,1 ,1 ,4370 ,35 ,1571 
4159032000,경기도 화성시 비봉면,읍면동,비봉면,2152,5803 ,4298 ,1785 ,2359 ,75 ,0 ,36 ,1 ,0 ,1 ,1 ,10 ,1 ,0 ,4269 ,29 ,1505 
4159033000,경기도 화성시 마도면,읍면동,마도면,2152,6466 ,4597 ,2047 ,2368 ,66 ,2 ,56 ,2 ,1 ,2 ,2 ,4 ,1 ,1 ,4552 ,45 ,1869 
4159034000,경기도 화성시 송산면,읍면동,송산면,2152,9203 ,6539 ,2471 ,3803 ,125 ,1 ,56 ,0 ,0 ,0 ,10 ,9 ,4 ,2 ,6481 ,58 ,2664 
4159035000,경기도 화성시 서신면,읍면동,서신면,2152,6192 ,4350 ,1734 ,2463 ,62 ,1 ,43 ,2 ,1 ,1 ,10 ,6 ,2 ,0 ,4325 ,25 ,1842 
4159036000,경기도 화성시 팔탄면,읍면동,팔탄면,2152,10244 ,7603 ,3628 ,3717 ,130 ,0 ,68 ,2 ,1 ,1 ,2 ,7 ,1 ,6 ,7563 ,40 ,2641 
4159037000,경기도 화성시 장안면,읍면동,장안면,2152,8204 ,5357 ,2396 ,2728 ,106 ,4 ,67 ,2 ,1 ,0 ,2 ,6 ,3 ,3 ,5318 ,39 ,2847 
4159040000,경기도 화성시 양감면,읍면동,양감면,2152,4709 ,3702 ,1701 ,1874 ,61 ,3 ,34 ,1 ,1 ,2 ,2 ,2 ,2 ,0 ,3683 ,19 ,1007 
4159041000,경기도 화성시 정남면,읍면동,정남면,2152,9809 ,6993 ,3048 ,3644 ,131 ,4 ,92 ,4 ,1 ,1 ,4 ,7 ,4 ,6 ,6946 ,47 ,2816 
4159051500,경기도 화성시 새솔동,읍면동,새솔동,2152,16707 ,13049 ,7339 ,5242 ,316 ,5 ,72 ,2 ,4 ,0 ,1 ,5 ,1 ,2 ,12989 ,60 ,3658 
4159052000,경기도 화성시 진안동,읍면동,진안동,2154,30857 ,21163 ,11045 ,9199 ,463 ,7 ,188 ,5 ,2 ,3 ,11 ,22 ,6 ,11 ,20962 ,201 ,9694 
4159053000,경기도 화성시 병점1동,읍면동,병점1동,2154,27125 ,20502 ,10839 ,8745 ,515 ,5 ,152 ,0 ,1 ,1 ,11 ,18 ,0 ,3 ,20290 ,212 ,6623 
4159054000,경기도 화성시 병점2동,읍면동,병점2동,2154,18222 ,13996 ,8054 ,5328 ,360 ,3 ,106 ,5 ,1 ,1 ,7 ,11 ,5 ,4 ,13885 ,111 ,4226 
4159055000,경기도 화성시 반월동,읍면동,반월동,2154,21646 ,16931 ,8898 ,7373 ,420 ,4 ,90 ,0 ,1 ,0 ,9 ,6 ,4 ,5 ,16810 ,121 ,4715 
4159056000,경기도 화성시 기배동,읍면동,기배동,2154,12241 ,9790 ,5487 ,3878 ,272 ,7 ,75 ,0 ,2 ,1 ,5 ,6 ,1 ,6 ,9740 ,50 ,2451 
4159057000,경기도 화성시 화산동,읍면동,화산동,2154,18277 ,13109 ,6894 ,5680 ,276 ,3 ,128 ,5 ,1 ,1 ,7 ,8 ,2 ,4 ,13009 ,100 ,5168 
4159058500,경기도 화성시 동탄1동,읍면동,동탄1동,2153,34329 ,26864 ,13442 ,12390 ,658 ,6 ,117 ,4 ,1 ,5 ,0 ,11 ,4 ,6 ,26644 ,220 ,7465 
4159058600,경기도 화성시 동탄2동,읍면동,동탄2동,2153,24438 ,19819 ,10993 ,8096 ,489 ,6 ,80 ,6 ,3 ,4 ,8 ,11 ,2 ,5 ,19703 ,116 ,4619 
4159058700,경기도 화성시 동탄3동,읍면동,동탄3동,2154,31190 ,24454 ,13792 ,9649 ,652 ,12 ,129 ,4 ,3 ,2 ,8 ,6 ,8 ,5 ,24270 ,184 ,6736 
4159058800,경기도 화성시 동탄4동,읍면동,동탄4동,2153,35181 ,29529 ,15454 ,13054 ,741 ,1 ,84 ,0 ,1 ,1 ,4 ,25 ,2 ,4 ,29371 ,158 ,5652 
4159059000,경기도 화성시 동탄5동,읍면동,동탄5동,2153,32099 ,24928 ,12981 ,10909 ,672 ,14 ,138 ,4 ,1 ,4 ,5 ,8 ,6 ,5 ,24747 ,181 ,7171 
4159060000,경기도 화성시 동탄6동,읍면동,동탄6동,2153,26072 ,19490 ,9650 ,9039 ,506 ,9 ,96 ,0 ,1 ,6 ,3 ,10 ,0 ,1 ,19321 ,169 ,6582 
4159061000,경기도 화성시 동탄7동,읍면동,동탄7동,2153,54776 ,42054 ,22408 ,18084 ,1048 ,11 ,192 ,5 ,4 ,8 ,13 ,18 ,5 ,4 ,41800 ,254 ,12722 
4159062000,경기도 화성시 동탄8동,읍면동,동탄8동,2153,22183 ,17650 ,9747 ,7166 ,498 ,3 ,85 ,1 ,2 ,4 ,6 ,14 ,2 ,2 ,17530 ,120 ,4533 
4161000000,경기도 광주시 ,시군구,광주시,,327252 ,244873 ,130220 ,105675 ,4596 ,99 ,1891 ,47 ,32 ,56 ,143 ,313 ,51 ,83 ,243206 ,1667 ,82379 
4161025000,경기도 광주시 오포읍,읍면동,오포읍,2156,77415 ,52918 ,28362 ,22718 ,933 ,17 ,414 ,7 ,5 ,18 ,32 ,64 ,6 ,16 ,52592 ,326 ,24497 
4161025300,경기도 광주시 초월읍,읍면동,초월읍,2156,34754 ,24654 ,12964 ,10805 ,486 ,4 ,177 ,4 ,2 ,5 ,19 ,28 ,6 ,6 ,24506 ,148 ,10100 
4161025900,경기도 광주시 곤지암읍,읍면동,곤지암읍,2156,19181 ,13632 ,6587 ,6515 ,239 ,14 ,140 ,4 ,1 ,2 ,7 ,15 ,5 ,9 ,13538 ,94 ,5549 
4161033000,경기도 광주시 도척면,읍면동,도척면,2156,7792 ,5576 ,2596 ,2789 ,96 ,3 ,50 ,3 ,0 ,1 ,2 ,5 ,3 ,1 ,5549 ,27 ,2216 
4161034000,경기도 광주시 퇴촌면,읍면동,퇴촌면,2155,12485 ,8993 ,4261 ,4463 ,121 ,3 ,65 ,1 ,2 ,4 ,4 ,8 ,1 ,2 ,8935 ,58 ,3492 
4161035000,경기도 광주시 남종면,읍면동,남종면,2155,1407 ,1152 ,406 ,704 ,16 ,2 ,10 ,0 ,0 ,0 ,3 ,0 ,1 ,1 ,1143 ,9 ,255 
4161037000,경기도 광주시 남한산성면,읍면동,남한산성면,2155,2273 ,1818 ,748 ,1019 ,27 ,0 ,10 ,0 ,0 ,0 ,2 ,3 ,0 ,0 ,1809 ,9 ,455 
4161051000,경기도 광주시 경안동,읍면동,경안동,2155,24713 ,18368 ,9310 ,8289 ,385 ,10 ,167 ,5 ,3 ,6 ,15 ,26 ,8 ,5 ,18229 ,139 ,6345 
4161052000,경기도 광주시 송정동,읍면동,송정동,2155,17039 ,12272 ,6228 ,5550 ,260 ,4 ,112 ,3 ,1 ,1 ,9 ,3 ,5 ,9 ,12185 ,87 ,4767 
4161054000,경기도 광주시 쌍령동,읍면동,쌍령동,2155,14153 ,10783 ,6094 ,4295 ,246 ,3 ,61 ,2 ,0 ,2 ,7 ,12 ,3 ,2 ,10727 ,56 ,3370 
4161055000,경기도 광주시 탄벌동,읍면동,탄벌동,2155,29520 ,20758 ,11453 ,8588 ,367 ,6 ,153 ,6 ,3 ,3 ,18 ,25 ,8 ,12 ,20642 ,116 ,8762 
4161056000,경기도 광주시 광남1동,읍면동,광남1동,2155,24297 ,16960 ,9317 ,7063 ,283 ,5 ,133 ,3 ,4 ,4 ,13 ,22 ,1 ,0 ,16848 ,112 ,7337 
4161057000,경기도 광주시 광남2동,읍면동,광남2동,2155,23599 ,18761 ,10761 ,7403 ,371 ,8 ,92 ,1 ,6 ,5 ,2 ,20 ,2 ,3 ,18674 ,87 ,4838 
4163000000,경기도 양주시 ,시군구,양주시,21571,197345 ,145562 ,75236 ,63800 ,3162 ,65 ,1475 ,36 ,20 ,31 ,111 ,287 ,41 ,70 ,144334 ,1228 ,51783 
4163025000,경기도 양주시 백석읍,읍면동,백석읍,2157,20638 ,14414 ,6963 ,6812 ,310 ,5 ,158 ,2 ,1 ,5 ,14 ,31 ,6 ,9 ,14316 ,98 ,6224 
4163031000,경기도 양주시 은현면,읍면동,은현면,2157,5161 ,3742 ,1522 ,2047 ,52 ,0 ,62 ,1 ,0 ,1 ,2 ,9 ,4 ,4 ,3704 ,38 ,1419 
4163032000,경기도 양주시 남면,읍면동,남면,2157,5746 ,3957 ,1606 ,2188 ,72 ,0 ,38 ,0 ,3 ,2 ,4 ,4 ,2 ,9 ,3928 ,29 ,1789 
4163033000,경기도 양주시 광적면,읍면동,광적면,2157,10385 ,7441 ,3444 ,3717 ,119 ,6 ,81 ,1 ,0 ,3 ,5 ,7 ,5 ,4 ,7392 ,49 ,2944 
4163034000,경기도 양주시 장흥면,읍면동,장흥면,2157,8742 ,6052 ,2520 ,3223 ,119 ,3 ,114 ,1 ,0 ,1 ,8 ,8 ,2 ,0 ,5999 ,53 ,2690 
4163051000,경기도 양주시 양주1동,읍면동,양주1동,2157,5222 ,3976 ,1834 ,1973 ,88 ,5 ,32 ,0 ,2 ,1 ,3 ,3 ,2 ,1 ,3944 ,32 ,1246 
4163052000,경기도 양주시 양주2동,읍면동,양주2동,2157,36330 ,26251 ,14495 ,10727 ,583 ,8 ,209 ,4 ,1 ,5 ,17 ,29 ,6 ,7 ,26091 ,160 ,10079 
4163053000,경기도 양주시 회천1동,읍면동,회천1동,2157,8640 ,6387 ,3185 ,2926 ,118 ,2 ,68 ,2 ,1 ,1 ,4 ,13 ,2 ,2 ,6324 ,63 ,2253 
4163054000,경기도 양주시 회천2동,읍면동,회천2동,2157,21485 ,14894 ,7999 ,6171 ,335 ,4 ,150 ,6 ,6 ,1 ,20 ,54 ,3 ,8 ,14757 ,137 ,6591 
4163055000,경기도 양주시 회천3동,읍면동,회천3동,2157,20748 ,15104 ,8002 ,6375 ,393 ,11 ,129 ,5 ,1 ,4 ,8 ,29 ,0 ,11 ,14968 ,136 ,5644 
4163056000,경기도 양주시 회천4동,읍면동,회천4동,2157,36675 ,26056 ,14674 ,10348 ,556 ,7 ,205 ,5 ,1 ,4 ,18 ,55 ,3 ,6 ,25882 ,174 ,10619 
4165000000,경기도 포천시 ,시군구,포천시,21581,131901 ,95968 ,44320 ,47306 ,1903 ,49 ,1056 ,26 ,17 ,22 ,113 ,158 ,43 ,50 ,95063 ,905 ,35933 
4165025000,경기도 포천시 소흘읍,읍면동,소흘읍,2158,35560 ,24879 ,12819 ,11058 ,507 ,4 ,251 ,2 ,6 ,6 ,23 ,32 ,2 ,8 ,24718 ,161 ,10681 
4165031000,경기도 포천시 군내면,읍면동,군내면,2158,6523 ,4612 ,1959 ,2437 ,89 ,3 ,57 ,2 ,3 ,3 ,5 ,8 ,5 ,2 ,4573 ,39 ,1911 
4165032000,경기도 포천시 내촌면,읍면동,내촌면,2158,3982 ,2863 ,1162 ,1571 ,36 ,2 ,43 ,0 ,0 ,1 ,3 ,2 ,2 ,1 ,2823 ,40 ,1119 
4165033000,경기도 포천시 가산면,읍면동,가산면,2158,6772 ,4851 ,2096 ,2581 ,74 ,3 ,36 ,1 ,1 ,3 ,6 ,7 ,7 ,4 ,4819 ,32 ,1921 
4165034000,경기도 포천시 신북면,읍면동,신북면,2158,9630 ,6454 ,2779 ,3410 ,113 ,4 ,69 ,2 ,0 ,0 ,8 ,13 ,5 ,2 ,6405 ,49 ,3176 
4165035000,경기도 포천시 창수면,읍면동,창수면,2158,1914 ,1495 ,562 ,874 ,21 ,1 ,18 ,0 ,1 ,0 ,3 ,3 ,0 ,1 ,1484 ,11 ,419 
4165036000,경기도 포천시 영중면,읍면동,영중면,2158,4221 ,3115 ,1330 ,1656 ,38 ,2 ,36 ,1 ,0 ,0 ,7 ,5 ,4 ,3 ,3082 ,33 ,1106 
4165037000,경기도 포천시 일동면,읍면동,일동면,2158,7999 ,5705 ,2328 ,3140 ,108 ,0 ,54 ,2 ,0 ,1 ,9 ,3 ,2 ,5 ,5652 ,53 ,2294 
4165038000,경기도 포천시 이동면,읍면동,이동면,2158,4838 ,3500 ,1391 ,1958 ,64 ,2 ,36 ,0 ,0 ,0 ,7 ,3 ,1 ,2 ,3464 ,36 ,1338 
4165039000,경기도 포천시 영북면,읍면동,영북면,2158,6666 ,4670 ,1871 ,2554 ,100 ,5 ,71 ,3 ,0 ,1 ,6 ,4 ,3 ,6 ,4624 ,46 ,1996 
4165040000,경기도 포천시 관인면,읍면동,관인면,2158,2348 ,1755 ,695 ,998 ,27 ,0 ,17 ,0 ,0 ,0 ,1 ,4 ,0 ,1 ,1743 ,12 ,593 
4165041000,경기도 포천시 화현면,읍면동,화현면,2158,2216 ,1625 ,591 ,946 ,36 ,0 ,20 ,1 ,0 ,1 ,8 ,2 ,1 ,1 ,1607 ,18 ,591 
4165051000,경기도 포천시 포천동,읍면동,포천동,2158,16343 ,11862 ,5700 ,5619 ,261 ,10 ,122 ,3 ,0 ,1 ,11 ,27 ,4 ,3 ,11761 ,101 ,4481 
4165052000,경기도 포천시 선단동,읍면동,선단동,2158,12450 ,8262 ,4170 ,3705 ,186 ,8 ,83 ,1 ,3 ,2 ,5 ,11 ,2 ,4 ,8180 ,82 ,4188 
4167000000,경기도 여주시 ,시군구,여주시,21591,98077 ,72566 ,30695 ,38731 ,1458 ,39 ,731 ,19 ,12 ,17 ,74 ,86 ,39 ,49 ,71950 ,616 ,25511 
4167025000,경기도 여주시 가남읍,읍면동,가남읍,2159,12068 ,8275 ,3714 ,4211 ,155 ,1 ,105 ,1 ,1 ,3 ,6 ,11 ,8 ,3 ,8219 ,56 ,3793 
4167031000,경기도 여주시 점동면,읍면동,점동면,2159,4528 ,3494 ,1309 ,2067 ,43 ,3 ,23 ,3 ,1 ,1 ,2 ,3 ,3 ,3 ,3461 ,33 ,1034 
4167032000,경기도 여주시 흥천면,읍면동,흥천면,2159,3965 ,2890 ,1002 ,1773 ,42 ,1 ,34 ,0 ,0 ,0 ,6 ,3 ,2 ,1 ,2864 ,26 ,1075 
4167033000,경기도 여주시 금사면,읍면동,금사면,2159,2415 ,1865 ,541 ,1265 ,20 ,2 ,10 ,1 ,1 ,0 ,1 ,0 ,1 ,0 ,1842 ,23 ,550 
4167034500,경기도 여주시 세종대왕면,읍면동,세종대왕면,2159,5125 ,3785 ,1373 ,2257 ,68 ,0 ,28 ,0 ,0 ,0 ,5 ,7 ,0 ,5 ,3743 ,42 ,1340 
4167035000,경기도 여주시 대신면,읍면동,대신면,2159,5705 ,4243 ,1440 ,2633 ,65 ,2 ,48 ,0 ,0 ,0 ,9 ,3 ,6 ,6 ,4212 ,31 ,1462 
4167036000,경기도 여주시 북내면,읍면동,북내면,2159,4055 ,2992 ,1104 ,1774 ,50 ,0 ,29 ,2 ,0 ,0 ,3 ,3 ,2 ,2 ,2969 ,23 ,1063 
4167037000,경기도 여주시 강천면,읍면동,강천면,2159,3732 ,2772 ,1104 ,1549 ,63 ,3 ,25 ,2 ,0 ,0 ,1 ,3 ,0 ,1 ,2751 ,21 ,960 
4167038000,경기도 여주시 산북면,읍면동,산북면,2159,2091 ,1634 ,615 ,956 ,29 ,0 ,15 ,0 ,0 ,2 ,0 ,3 ,3 ,4 ,1627 ,7 ,457 
4167051000,경기도 여주시 여흥동,읍면동,여흥동,2159,17065 ,11834 ,5190 ,6132 ,242 ,10 ,118 ,2 ,1 ,3 ,10 ,18 ,4 ,8 ,11738 ,96 ,5231 
4167052000,경기도 여주시 중앙동,읍면동,중앙동,2159,14535 ,10162 ,4551 ,5120 ,256 ,5 ,108 ,2 ,1 ,4 ,12 ,16 ,4 ,3 ,10082 ,80 ,4373 
4167053000,경기도 여주시 오학동,읍면동,오학동,2159,14203 ,10131 ,4977 ,4727 ,224 ,6 ,92 ,3 ,2 ,1 ,13 ,9 ,3 ,6 ,10063 ,68 ,4072 
4180000000,경기도 연천군 ,시군구,연천군,21232,37817 ,28904 ,12013 ,15325 ,604 ,17 ,402 ,7 ,5 ,13 ,64 ,50 ,22 ,27 ,28549 ,355 ,8913 
4180025000,경기도 연천군 연천읍,읍면동,연천읍,2123,6046 ,4507 ,1884 ,2387 ,84 ,4 ,56 ,3 ,0 ,2 ,5 ,15 ,3 ,4 ,4447 ,60 ,1539 
4180025300,경기도 연천군 전곡읍,읍면동,전곡읍,2123,14595 ,10415 ,4539 ,5362 ,229 ,5 ,148 ,1 ,0 ,4 ,9 ,13 ,10 ,5 ,10325 ,90 ,4180 
4180031000,경기도 연천군 군남면,읍면동,군남면,2123,2457 ,1816 ,717 ,1013 ,41 ,1 ,21 ,1 ,0 ,1 ,3 ,4 ,1 ,1 ,1804 ,12 ,641 
4180032000,경기도 연천군 청산면,읍면동,청산면,2123,3357 ,2508 ,914 ,1432 ,40 ,3 ,34 ,1 ,1 ,1 ,42 ,5 ,2 ,6 ,2481 ,27 ,849 
4180033000,경기도 연천군 백학면,읍면동,백학면,2123,2154 ,1638 ,631 ,927 ,36 ,1 ,27 ,0 ,1 ,0 ,0 ,1 ,2 ,1 ,1627 ,11 ,516 
4180034000,경기도 연천군 미산면,읍면동,미산면,2123,1333 ,1001 ,376 ,585 ,15 ,0 ,11 ,0 ,0 ,0 ,2 ,1 ,0 ,2 ,992 ,9 ,332 
4180035000,경기도 연천군 왕징면,읍면동,왕징면,2123,937 ,761 ,286 ,448 ,12 ,0 ,8 ,0 ,1 ,0 ,0 ,1 ,1 ,1 ,758 ,3 ,176 
4180036000,경기도 연천군 신서면,읍면동,신서면,2123,2353 ,1867 ,776 ,994 ,26 ,1 ,31 ,1 ,0 ,4 ,1 ,3 ,2 ,4 ,1843 ,24 ,486 
4180037000,경기도 연천군 중면,읍면동,중면,2123,190 ,156 ,67 ,80 ,4 ,0 ,3 ,0 ,0 ,0 ,0 ,0 ,0 ,0 ,154 ,2 ,34 
4180038000,경기도 연천군 장남면,읍면동,장남면,2123,641 ,530 ,193 ,310 ,15 ,0 ,6 ,0 ,0 ,0 ,0 ,0 ,0 ,0 ,524 ,6 ,111 
4182000000,경기도 가평군 ,시군구,가평군,21582,55618 ,42512 ,16684 ,23870 ,872 ,30 ,402 ,16 ,6 ,18 ,47 ,44 ,30 ,30 ,42049 ,463 ,13106 
4182025000,경기도 가평군 가평읍,읍면동,가평읍,2158,15629 ,11538 ,4706 ,6389 ,255 ,2 ,75 ,2 ,1 ,3 ,5 ,7 ,7 ,6 ,11458 ,80 ,4091 
4182031000,경기도 가평군 설악면,읍면동,설악면,2158,7473 ,5558 ,1933 ,3429 ,92 ,1 ,38 ,1 ,1 ,1 ,9 ,3 ,2 ,5 ,5515 ,43 ,1915 
4182032500,경기도 가평군 청평면,읍면동,청평면,2158,11292 ,8330 ,3269 ,4731 ,165 ,5 ,76 ,1 ,0 ,2 ,12 ,5 ,3 ,4 ,8273 ,57 ,2962 
4182033000,경기도 가평군 상면,읍면동,상면,2158,4593 ,3426 ,1249 ,2010 ,70 ,4 ,37 ,1 ,0 ,2 ,2 ,2 ,2 ,4 ,3383 ,43 ,1167 
4182034500,경기도 가평군 조종면,읍면동,조종면,2158,7288 ,5176 ,2045 ,2769 ,119 ,10 ,77 ,10 ,3 ,7 ,6 ,7 ,10 ,3 ,5066 ,110 ,2112 
4182035000,경기도 가평군 북면,읍면동,북면,2158,3086 ,2343 ,819 ,1433 ,37 ,1 ,25 ,0 ,0 ,0 ,4 ,5 ,1 ,2 ,2327 ,16 ,743 
4183000000,경기도 양평군 ,시군구,양평군,21592,106406 ,83065 ,34324 ,45487 ,1662 ,40 ,633 ,21 ,12 ,26 ,80 ,57 ,34 ,48 ,82424 ,641 ,23341 
4183025000,경기도 양평군 양평읍,읍면동,양평읍,2159,22411 ,16105 ,6692 ,8744 ,382 ,7 ,143 ,3 ,2 ,2 ,13 ,9 ,7 ,5 ,16009 ,96 ,6306 
4183031000,경기도 양평군 강상면,읍면동,강상면,2159,8590 ,6801 ,3008 ,3559 ,144 ,2 ,45 ,2 ,2 ,2 ,8 ,2 ,3 ,1 ,6778 ,23 ,1789 
4183032000,경기도 양평군 강하면,읍면동,강하면,2159,3872 ,2990 ,1081 ,1822 ,41 ,1 ,20 ,0 ,0 ,1 ,5 ,2 ,2 ,0 ,2975 ,15 ,882 
4183033000,경기도 양평군 양서면,읍면동,양서면,2159,10366 ,7692 ,3260 ,4126 ,165 ,5 ,43 ,0 ,1 ,5 ,12 ,7 ,0 ,6 ,7630 ,62 ,2674 
4183034000,경기도 양평군 옥천면,읍면동,옥천면,2159,7243 ,5748 ,2471 ,3055 ,115 ,1 ,60 ,1 ,0 ,3 ,2 ,4 ,1 ,2 ,5715 ,33 ,1495 
4183035000,경기도 양평군 서종면,읍면동,서종면,2159,6953 ,5286 ,2179 ,2932 ,90 ,0 ,26 ,4 ,0 ,1 ,9 ,3 ,3 ,2 ,5249 ,37 ,1667 
4183036000,경기도 양평군 단월면,읍면동,단월면,2159,3311 ,2550 ,974 ,1484 ,35 ,3 ,19 ,0 ,1 ,2 ,1 ,0 ,0 ,4 ,2523 ,27 ,761 
4183037000,경기도 양평군 청운면,읍면동,청운면,2159,3184 ,2371 ,843 ,1432 ,40 ,1 ,13 ,2 ,1 ,3 ,4 ,4 ,3 ,2 ,2348 ,23 ,813 
4183038000,경기도 양평군 양동면,읍면동,양동면,2159,3752 ,2831 ,978 ,1744 ,47 ,4 ,20 ,1 ,1 ,1 ,2 ,5 ,2 ,4 ,2809 ,22 ,921 
4183039500,경기도 양평군 지평면,읍면동,지평면,2159,5853 ,4466 ,1773 ,2541 ,64 ,1 ,32 ,3 ,1 ,1 ,7 ,2 ,4 ,4 ,4433 ,33 ,1387 
4183040000,경기도 양평군 용문면,읍면동,용문면,2159,13726 ,10210 ,4246 ,5559 ,183 ,8 ,93 ,4 ,2 ,1 ,5 ,9 ,3 ,8 ,10121 ,89 ,3516 
4183041000,경기도 양평군 개군면,읍면동,개군면,2159,4358 ,3408 ,1344 ,1939 ,68 ,0 ,21 ,0 ,0 ,0 ,7 ,1 ,2 ,2 ,3384 ,24 ,950 
